--------------------------------------------------------------------------------------------------------------------------------------------------------------------------------------------------------
--------------------------------------------------------------------------------------------------------------------------------------------------------------------------------------------------------
--------------------------------------------------------------------------------------------------------------------------------------------------------------------------------------------------------
--------------------------------------------------------------------------------------------------------------------------------------------------------------------------------------------------------
--------------------------------------------------------------------------------------------------------------------------------------------------------------------------------------------------------
--------------------------------------------------------------------------------------------------------------------------------------------------------------------------------------------------------
--------------------------------------------------------------------------------------------------------------------------------------------------------------------------------------------------------
-------------------------------------------------------------------------------------------------------------------------------------------------------------------------------------------------------v
------------o-----oo----------o-----------o-------------------------------o-o-------------------o----o-------------------o--o----oo--o-----------oo-oo-o----o---o-------o--o--o-o----------------------f
-------o?----------B---?-o--?---BM-----------B-oo--------B-------o--?-----?o-?----o---B-----------o-o--B-o--B-B--o-----o-o-----o?o------oo?--oo---B--o-o-----o--o--Mo--o?oo-M--o-M--B--------oB--------f
--------o-o-----o------o----o--------M-o-------M-o--M--------o?-M---------oB-o------o-------M----------------?---oB-o------oM------------B--o-----oo----M---B---------o--------o-M-----------o---------f
-----------M--o---------------o--------M--o----------M-To---T----o-o------o-B---o------------------T---Boo---ooT-----oM--oo-o-o----------oT-------?-----B-----B------o-o--------T-----Mo?------?M------f
-------o---?------T-----oo-o--T-o?---T-----M-M-B----B--|----|o--o--o--M----o----oB-M-?-B-----T--?-o|----------o|--B-MoB-o--o--------o-B---|?-----Mo---o---------------B--------o|---o------?--M--------f
------------------|----?------|---M--|-----------?---T-|----|-TM----BM-----?-?--B------------|----M|---M--M----|--------------?-----------|-------B----------B------------?-----|----------T-M---------f
m---EEEEEEE--EE---|---------E-|------|--E-E--E--E-E--|E|----|-|------E-E----EE----EE----E-E--|E----|-----E-----|E-------E-----E---E-------|----E--E------E------EE-E---E---E--E-|------EE-E|-----------X
XXXXXXXXXXXXXXXXXXXXXXXXXXXXXXXXXXXXXXXXXXXXXXXXXXXXXXXXXXXXXXXXXXXXXXXXXXXXXXXXXXXXXXXXXXXXXXXXXXXXXXXXXXXXXXXXXXXXXXXXXXXXXXXXXXXXXXXXXXXXXXXXXXXXXXXXXXXXXXXXXXXXXXXXXXXXXXXXXXXXXXXXXXXXXXXXXXXXXXXX
