--------------------------------------------------------------------------------------------------------------------------------------------------------------------------------------------------------
--------------------------------------------------------------------------------------------------------------------------------------------------------------------------------------------------------
--------------------------------------------------------------------------------------------------------------------------------------------------------------------------------------------------------
--------------------------------------------------------------------------------------------------------------------------------------------------------------------------------------------------------
--------------------------------------------------------------------------------------------------------------------------------------------------------------------------------------------------------
--------------------------------------------------------------------------------------------------------------------------------------------------------------------------------------------------------
--------------------------------------------------------------------------------------------------------------------------------------------------------------------------------------------------------
--------------------------------------------------------------------------------------------------------------------------------------------------------------------------------------------------------
------------o--------o-----------o-----o-----------o----o---------ooo---------o-----------------o-ooo-------o--o------oo----o--oo-------oo----o---------o-----------------------oo---o------o-----------
--------B-----oB---M-----o-?----o------?------B-o--?-M-----Boo-------?----------?-?------ooBo----M--B-----B-M---o---------B--oB-B-o--M--?--o--o----?--o-o---o------B---Booo--?o-------o--o-------B------
----------B--B?-?-------Bo-----o--------o-o--o-o---M-M------------oM---?--o--o-?----B------o-M--o--o---?---o-oo---o--M---o---------oo----o---o---M-----o---??B---o-ooo-o--o----o---o---B----B-o-o-------
-----------o----B?-o----------------ooB-------o-o------o------o--------?Bo---M----------B-----B--M-o-----M--?------o---o---?--o----oB?Mo----B----To----o-oo-----------------o-----TT---To-----o-B?------
--------------T-----oTM-M-----B-o--BM---o-B--o------o-o-------------T--M-BoT-----o-T---o-----?o-T--------------o-------o--T----o-Mo-o----oT----?-|-o--vo----?--o----------o---o---||---|--?---?-M-------
-----------?--|------|-?---------B----------M-----M------?----------|---T--|--?----|-M---T------|-T--?-----------?--------|-B-------------|--?---|-T--f---------------------------||-T-|----------------
m-------------|------|---------------------------------------EE-----|-E-|EE|---E---|-----|------|-|E----E-----------------|---------------|-----E|-|--f----------E--------------E-||-|-|-----E-----E----
XXXXXXXXXXXXXXXXXXXXXXXXXXXXXXXXXXXXXXXXXXXXXXXXXXXXXXXXXXXXXXXXXXXXXXXXXXXXXXXXXXXXXXXXXXXXXXXXXXXXXXXXXXXXXXXXXXXXXXXXXXXXXXXXXXXXXXXXXXXXXXXXXXXXXXXXXXXXXXXXXXXXXXXXXXXXXXXXXXXXXXXXXXXXXXXXXXXXXXXX
