--------------------------------------------------------------------------------------------------------------------------------------------------------------------------------------------------------
--------------------------------------------------------------------------------------------------------------------------------------------------------------------------------------------------------
--------------------------------------------------------------------------------------------------------------------------------------------------------------------------------------------------------
--------------------------------------------------------------------------------------------------------------------------------------------------------------------------------------------------------
--------------------------------------------------------------------------------------------------------------------------------------------------------------------------------------------------------
--------------------------------------------------------------------------------------------------------------------------------------------------------------------------------------------------------
--------------------------------------------------------------------------------------------------------------------------------------------------------------------------------------------------------
-------------------------------------------------------------------------------------------------------------------------------------------------------------------------------------------------------v
--------------o--o---o---------o------o------------o----o-o--o----o---------o---------o---oo----o-------------------o---------------o--------o---o--o-o---------------o----o---------------------------f
--------??------------?----o--o--B---M?---o----o---o-?---o-B--?-o--o--------o-M?----o?--o-----------?M-M------------MM---oM-MM?MB----B-o----Mo--o-o-?----oM--o?---M-?----oB--------?-?----o-?--?-------f
-------M-----------MB-o----o-----o-MB-------??-----Booo-o-o-?--M-B-M--o-M-o------------oo--B-------------ooB-o-------oB-o-ooo-o---oo----?o--o--o-B-------o--o---o-------Bo--------------o---?----------f
---------?----?-?o--------o----?-BM?---o-----?-o------B-?----T---o---o-----o--o--T-------MooTo------M-----oooo------B----T-----------?-------------T---M--M-o-o------M----o------o---M---o---oT--T-----f
---------------o--o-----o-TT-Mo-o-----M-ooo---M--o-B--oo-----|o-M----------M-----|M------o--|--?---B-ooo--T-BM-To--------|-----------------Mo-?o---|-?-----T----B----o------o?---?-T-T--------|-M|-----f
------------?--?--M----M--||--------B--M-?B--T------?-------M|B--------M-----T---T-----M---M|T-------M----|----|?------M-|----------B---MT--M--M--M|-?-M---|-------?------B--------|-|--------|M-|-----f
m-EEE---E-----E-E-E--E--E-||---E-E-----------|E-----E-E-EEE--|---------E-----|---|E-E----E-E||-E--E-------|---E|E------E-|-E------E--E---|E--------|--E----|--E-----E----E---------|-|-----EE-|E-|E-E--X
XXXXXXXXXXXXXXXXXXXXXXXXXXXXXXXXXXXXXXXXXXXXXXXXXXXXXXXXXXXXXXXXXXXXXXXXXXXXXXXXXXXXXXXXXXXXXXXXXXXXXXXXXXXXXXXXXXXXXXXXXXXXXXXXXXXXXXXXXXXXXXXXXXXXXXXXXXXXXXXXXXXXXXXXXXXXXXXXXXXXXXXXXXXXXXXXXXXXXXXX
