--------------------------------------------------------------------------------------------------------------------------------------------------------------------------------------------------------
--------------------------------------------------------------------------------------------------------------------------------------------------------------------------------------------------------
--------------------------------------------------------------------------------------------------------------------------------------------------------------------------------------------------------
--------------------------------------------------------------------------------------------------------------------------------------------------------------------------------------------------------
--------------------------------------------------------------------------------------------------------------------------------------------------------------------------------------------------------
--------------------------------------------------------------------------------------------------------------------------------------------------------------------------------------------------------
--------------------------------------------------------------------------------------------------------------------------------------------------------------------------------------------------------
---------------------------------------------------------------------------------------------------------------------------------------------------------------------------------------------------v----
-------------------------------------------------------------------------------------------------------o----------------------------------o--------------------------------------------------------f----
--------------------------------------------------------------------------------------------------------o---------------------------------------------------------------o--------------------------f----
-----------------------------------M-----------------o--------M------------------------------------------------------?----------------------------------------------------------------------B------f----
----------------------o---------------------------------------------------------?------------------------------------------------------?---------M---------------------------o-----o-----o----o----f----
----------------o---------------------------------------------------------------------------o-------------------------------------------------------------B--------------------------?-------------f----
-------------------M-----------------------------------------------------------------------------------------B---------------------------------------------------------M---------------------------f----
m-------------------------E-----------------------------------------------------------------------------------------------E------------------------------------------------------------------------X----
XXXXXXXXXXXXXXXXXXXXXXXXXXXXXXXXXXXXXXXXXXXXXXXXXXXXXXXXXXXXXXXXXXXXXXXXXXXXXXXXXXXXXXXXXXXXXXXXXXXXXXXXXXXXXXXXXXXXXXXXXXXXXXXXXXXXXXXXXXXXXXXXXXXXXXXXXXXXXXXXXXXXXXXXXXXXXXXXXXXXXXXXXXXXXXXXXXXXXXXX
