--------------------------------------------------------------------------------------------------------------------------------------------------------------------------------------------------------
--------------------------------------------------------------------------------------------------------------------------------------------------------------------------------------------------------
--------------------------------------------------------------------------------------------------------------------------------------------------------------------------------------------------------
--------------------------------------------------------------------------------------------------------------------------------------------------------------------------------------------------------
--------------------------------------------------------------------------------------------------------------------------------------------------------------------------------------------------------
--------------------------------------------------------------------------------------------------------------------------------------------------------------------------------------------------------
--------------------------------------------------------------------------------------------------------------------------------------------------------------------------------------------------------
-------------------------------------------------------------------------------------------------------------------------------------------------------------------------------------------------------v
-------o-o----------o-o----o----------o---------------oo----o-------o------oo----o--------------------oo---oo----------------------o---------o--o--o----o--o----o-----o-------o-------o--o---o---------f
-------o?-----------o---?----o--------o??-------M-o---?-oB---Bo---------?---o-o----?M----?-o----o--B---o-B-o-----B--??B-----oo------?ooo---?----------?-------B-----B---------------o----?M------------f
--------o--B---Bo----------------o-o--o---M---------oM--M----oo----o------ooo--o-------B---o-oo--o---------o----Boo-o-o----o---------o-----?------ooo------------o--o---?o-----B---o-------------o-----f
-------?o----o---o----Mo--M-M----T--o--T--T------o--M---T---------o?o-------T--------o-TBo--To--?o--ooo--o-o--o----B----------oT-----o------?M---M---B-------B---M--oo---------ooT---?----------o------f
---------o-M----------o----------|-B-B-|?-|----------o--|-------------------|o------?--|M---|MM--B-o----M-o------?o--M---o----o|---o----o-----To-o---o---------ooM-o------?--oo-M|MB------oM-----o-----f
--------------------------------T|-----|--|----------?--|----T--------------|-?--------|T--B|----------M-M----------------B----|------T-------|----------------------------------|------B-------?------f
m------EE---EE----E------E--E---||E--E-|E-|-----E-------|-E--|--------E-----|------E--E||-E-|--------------E-E----------E-E--E-|E-E---|-EE----|-E-E---E---E----E-------E--E--EE-E|----EE---E---E-------X
XXXXXXXXXXXXXXXXXXXXXXXXXXXXXXXXXXXXXXXXXXXXXXXXXXXXXXXXXXXXXXXXXXXXXXXXXXXXXXXXXXXXXXXXXXXXXXXXXXXXXXXXXXXXXXXXXXXXXXXXXXXXXXXXXXXXXXXXXXXXXXXXXXXXXXXXXXXXXXXXXXXXXXXXXXXXXXXXXXXXXXXXXXXXXXXXXXXXXXXX
