--------------------------------------------------------------------------------------------------------------------------------------------------------------------------------------------------------
--------------------------------------------------------------------------------------------------------------------------------------------------------------------------------------------------------
--------------------------------------------------------------------------------------------------------------------------------------------------------------------------------------------------------
--------------------------------------------------------------------------------------------------------------------------------------------------------------------------------------------------------
--------------------------------------------------------------------------------------------------------------------------------------------------------------------------------------------------------
--------------------------------------------------------------------------------------------------------------------------------------------------------------------------------------------------------
--------------------------------------------------------------------------------------------------------------------------------------------------------------------------------------------------------
--------------------------------------------------------------------------------------------------------------------------------------------------------------------------------------------------------
--------o---------o--o-----o------o------o---------oo-o-----------o-----------------o-----------o-oo-----------o-------------------------------o------o-o---------o--o--------o------o------o---o-------
-------?-------------M--Bo-------Mo--o-?------B----o?M-o------?--o--o--B----o-o--B--o-B--o-------M---M?---------oB----o-------o---------?--M-B---------?-oo-------BM------------?o--B----?--------------
-----------o-oo---oo---o----ooo--B-------?o--oo--------------------oB-----M------B--o-o----M--o--------------oo------o-?--o--o-------?--------o-?---o-o?-----oo--------B--o--o-o?--Mv-o---------M-------
-----------o-------?-------M----B----o-----o-o-----?-----T-------T-----o----Mo-Mo-o---Mo-MT------o----o-----B-o--Boo---------o----o---To--o------M---T------o------o--B------------Bf--o-T-T--o---------
-------B-?----------T?---o-Mo---T-------------o--o------o|MM---o-|--oM--T--?---------T--o-|--T-----?-o----B--------o---ooo-o----------|----o---------|-B--------o-----o-o-----MB-o--f----|-|----Mo------
--------------------|----------T|-------?------------?--B|-------|-----T|-------?--M-|-?--|?-|-------------------M------M---?-M--BT---|-----T--------|---------------T--------------f---?|-|----BM------
m------E------------|-E-------E||--------E-E---E---------|-------|-----||------------|---E|--|------E----------------------E-E----|---|-----|--------|--E--EE--------|---E----------f----|-|------------
XXXXXXXXXXXXXXXXXXXXXXXXXXXXXXXXXXXXXXXXXXXXXXXXXXXXXXXXXXXXXXXXXXXXXXXXXXXXXXXXXXXXXXXXXXXXXXXXXXXXXXXXXXXXXXXXXXXXXXXXXXXXXXXXXXXXXXXXXXXXXXXXXXXXXXXXXXXXXXXXXXXXXXXXXXXXXXXXXXXXXXXXXXXXXXXXXXXXXXXX
