--------------------------------------------------------------------------------------------------------------------------------------------------------------------------------------------------------
--------------------------------------------------------------------------------------------------------------------------------------------------------------------------------------------------------
--------------------------------------------------------------------------------------------------------------------------------------------------------------------------------------------------------
--------------------------------------------------------------------------------------------------------------------------------------------------------------------------------------------------------
--------------------------------------------------------------------------------------------------------------------------------------------------------------------------------------------------------
--------------------------------------------------------------------------------------------------------------------------------------------------------------------------------------------------------
--------------------------------------------------------------------------------------------------------------------------------------------------------------------------------------------------------
---------------------------------------------------------------------------------------------------------------------------------------------------------------------------------------------------v----
---------------------------------------------------------------------------------------------------------------------------------------------------------o---------o-------------------------------f----
----------------------------------------------------------------------------------------------------------------------------o----------------------------------------------------------------------f----
---?-----------------------------?-----------------------------------------------------------o-----------------------------------------------------------------------------------------?-----------f----
-------------------------------------------------------------------o------------------------------M--------o--------------------------------------------------B-----------------------------------Bf----
--------------TT-------------------o-------o-----------------------------------M--------------------------B------------------------------M-------------B----------------o-----------------------o--f----
--------------||------------------------------------------------------------------------TT-M--------------------------------------M----------------------------------------------------------------f----
m----E--------||---------------------E-----------------------------E--------------------||-----------------------------------------E--------------------------E------------------------------------X----
XXXXXXXXXXXXXXXXXXXXXXXXXXXXXXXXXXXXXXXXXXXXXXXXXXXXXXXXXXXXXXXXXXXXXXXXXXXXXXXXXXXXXXXXXXXXXXXXXXXXXXXXXXXXXXXXXXXXXXXXXXXXXXXXXXXXXXXXXXXXXXXXXXXXXXXXXXXXXXXXXXXXXXXXXXXXXXXXXXXXXXXXXXXXXXXXXXXXXXXX
