--------------------------------------------------------------------------------------------------------------------------------------------------------------------------------------------------------
--------------------------------------------------------------------------------------------------------------------------------------------------------------------------------------------------------
--------------------------------------------------------------------------------------------------------------------------------------------------------------------------------------------------------
--------------------------------------------------------------------------------------------------------------------------------------------------------------------------------------------------------
--------------------------------------------------------------------------------------------------------------------------------------------------------------------------------------------------------
--------------------------------------------------------------------------------------------------------------------------------------------------------------------------------------------------------
--------------------------------------------------------------------------------------------------------------------------------------------------------------------------------------------------------
-------------------------------------------------------------------------------------------------------------------------------------------------------------------------------------------------------v
-------o--------------o----ooo--o-------oo-o-o----o------------------o-o-o---o------o----o--------o-o--o-----o----o-----o-------------------o-----o-oo--o-o-o-o--oo--o----o---o---o-----oo--oo-o-o-----f
------?---o---o--BMoo-M-Bo---?-oo???oo-o---o?o---B--oB-----o-B-o----B?-B-oo-o----BoM-M?-o--Bo--o-oB-M--M?-----B--o---?--?-o-----?--o-M---o---B--o-?MoBo-M-oB-o--?--M--?ooMMo??Bo----?BMo----o---BM-----f
------ooo-o-oo---?-?--?--M--ooo-----Mo-------oB-o--B-----B-B-Boo--o---o------oM----oo--o-------?-oB?--o---M--o---o---------B-M-----Boo---oo-?--o-o--M---o-?Moo--ooMo-o----M-o-M-o-o-?------?-o--B------f
-------oo--o--oMT---M--o-oT----?o-----M?M--o------oT-oo-B--oT------MooB-o-o?--o-?----ooo----B--MB---T---o--ooMoo--------o---o-----o?o----?o-o----M-?-?-oooo?-o?---M---oo-o--M--ooooM------Mo--?-T------f
------o---B--ooT|--o-o-o--|To----oM-MB--M-M-B-oMoB-|-Bo-M-oMT-oo-----Mo-?-ooMo-o---??o-M-TB---oMo--o|-B--T--T--------M---------o---T-Mo-M--M------B---------MM-o-------oB-oBM---?oM------o?-Bo-o|------f
-------------?-||--M?-----||-----M--T-B----M-------|---TBM--|-----?-M?T-?---T-------T---B|-------T-M|--M-|--|----T-----------B--B--|------MT?-------------B-T-B--T----TMT-M------B----?--M------|M-----f
mEE-EE-E-E---EE||E--E----E||----E---|-E---EE---EE--|---|----|--EE----E|-E---|------E|-E--|-------|--|----|--|----|--E-----E--------|-------|-------E--------|-E-E|E--E|-|-------------E---------|------X
XXXXXXXXXXXXXXXXXXXXXXXXXXXXXXXXXXXXXXXXXXXXXXXXXXXXXXXXXXXXXXXXXXXXXXXXXXXXXXXXXXXXXXXXXXXXXXXXXXXXXXXXXXXXXXXXXXXXXXXXXXXXXXXXXXXXXXXXXXXXXXXXXXXXXXXXXXXXXXXXXXXXXXXXXXXXXXXXXXXXXXXXXXXXXXXXXXXXXXXX
