--------------------------------------------------------------------------------------------------------------------------------------------------------------------------------------------------------
--------------------------------------------------------------------------------------------------------------------------------------------------------------------------------------------------------
--------------------------------------------------------------------------------------------------------------------------------------------------------------------------------------------------------
--------------------------------------------------------------------------------------------------------------------------------------------------------------------------------------------------------
--------------------------------------------------------------------------------------------------------------------------------------------------------------------------------------------------------
--------------------------------------------------------------------------------------------------------------------------------------------------------------------------------------------------------
--------------------------------------------------------------------------------------------------------------------------------------------------------------------------------------------------------
-------------------------------------------------------------------------------------------------------------------------------------------------------------------------------------------------------v
------o--o--ooo--------oo------oo-o--o---o-o-oo--oo--oo--o---oo--o---o--o-o----oo-o-o-----o--o--oo-o--o--o--o-o-------o-o---o-----------o---o--oo-----ooooo-oo--o--o-o-o--o-o---------o-o----o---------f
------B-o--MB-oBo-B?-?-o--ooB--oB-o---BM-Bo--o-o-?Bo-?-Mo-?-B--o-o--oB?--oo--oB?ooo-o-?-M?-Boo-ooo?M-o-BBM?-?-o?--o?o?--?-o---o-?o?o-o-?--o?-B----o--BoooBo-Mo?-oooMMM--?ooo-oM-o?-oM-o-BBo--o?oM------f
-----------o--Moooo?-----M-o?-M---o-ooB--o-?Mo-Mooo----MB-o---Mo-Booo-oo-M----o?Bo-oo----o-?MBoooo-oBoM-oBMoo-oooMMoo-o----B-M--B--Boo---o--?oooB--M----Boo---M---B-o----oo-M---B-BMM--o-----MM?M------f
----------oB---M--MoM-o-----?-B--oBT-M-M?-Boo?oMooM-MBM?MBT--M-ooT-M--oMoooMB-----------oo-oB-oM-T-MM-M?-oooTo---M--?---o---o------?o----?--o--MBT--M-M---oMM--BTMB--B-Too-B-oo-oo-oMo-oBo-----T-M-----f
---------oM---MoBB---T---o-?MM----oT--B---ooooo-o------T--|--T---|oB---ooTB--oo-o-o?Boo-oTBo--oo-|MooB-ooooM|--oo-o--M-o-------o---T-Mo-M-o-oBM--|-T---Bo--o--o?|---o-o|-M?---oo-o-M-?---oMB-Bo|-------f
-------?-T------T--M-|BB?----------|---?--MMMMB----T---|-T|M-|--B|--M---?|?-B-------T-MM-|MB-----|--M-?-M---|--MM-BM----M----B-----|M-----------M|-|-M?T---B-?--|-M----|---B--M-MT-?M---?---BTM|-------f
mEE-EEEE-|------|-E-E|--E--E---E---|-E-E---E-------|E--|E||--|---|--E----|-------E--|----|---E---|--E---EE--|-----E-------E----E---|----------E--|-|---|--------|------|--------E|-----------|-|-------X
XXXXXXXXXXXXXXXXXXXXXXXXXXXXXXXXXXXXXXXXXXXXXXXXXXXXXXXXXXXXXXXXXXXXXXXXXXXXXXXXXXXXXXXXXXXXXXXXXXXXXXXXXXXXXXXXXXXXXXXXXXXXXXXXXXXXXXXXXXXXXXXXXXXXXXXXXXXXXXXXXXXXXXXXXXXXXXXXXXXXXXXXXXXXXXXXXXXXXXXX
