--------------------------------------------------------------------------------------------------------------------------------------------------------------------------------------------------------
--------------------------------------------------------------------------------------------------------------------------------------------------------------------------------------------------------
--------------------------------------------------------------------------------------------------------------------------------------------------------------------------------------------------------
--------------------------------------------------------------------------------------------------------------------------------------------------------------------------------------------------------
--------------------------------------------------------------------------------------------------------------------------------------------------------------------------------------------------------
--------------------------------------------------------------------------------------------------------------------------------------------------------------------------------------------------------
--------------------------------------------------------------------------------------------------------------------------------------------------------------------------------------------------------
-------------------------------------------------------------------------------------------------------------------------------------------------------------------------------------------------------v
-------------o-----o-------------o---------oo---o------o----------o----------------------o----o---------o-o---------------------o------------o----o---------o------------------------o---oo-o----------f
-------?o--o----o---------B--o-?------o-?o-o----?---------B---o-----B--------o-B?----o-B---------o--Bo----B------?-----------oMo---?----oB--Bo-------M---B------B-Mo--M-----------o-----?-------Bo-----f
--------M--oB-?------?o------------o--oo----oo--o--o-?---------oB-o----------B---------o-M--o---o-----------B-?-o----o-?--oo-----o--------?-----M----M--oo----Mo-------Mo-?--Bo-----M--------MB--------f
-------------?BM--B--o-o--------T-M------oM---?--?-----------------?-------o--o-o--------o------M------o-----------oo-----B-T---o--o-------B----T------M----oo------o-B--o--oo------M---o---To--B------f
--------oo--o-o-T-o--B------o---|----B--o-o?---oT----o-------o--------o--B-------?Bo------------o------o--o--oo-------------|-B-BT--?---o-o-----|---o-------ooo--o--M------o-o---?----------|M--o------f
------------B---|----?---T--?M--|-------?-------|----?-M-----T-T------?----M--B-?-------B--M-----------?--------------------|-M--|--------------|-----T--M-----------T--M------------T?-----|----------f
m----EE--E----E-|-EE-E---|-----E|-E--E--E-E-----|----------EE|-|------E---E---------------E---------------E--------EE-EE----|-E-E|---E------E---|-----|E------EE-E---|--E--EEEE--EE--|--E--E|E-E---E---X
XXXXXXXXXXXXXXXXXXXXXXXXXXXXXXXXXXXXXXXXXXXXXXXXXXXXXXXXXXXXXXXXXXXXXXXXXXXXXXXXXXXXXXXXXXXXXXXXXXXXXXXXXXXXXXXXXXXXXXXXXXXXXXXXXXXXXXXXXXXXXXXXXXXXXXXXXXXXXXXXXXXXXXXXXXXXXXXXXXXXXXXXXXXXXXXXXXXXXXXX
