--------------------------------------------------------------------------------------------------------------------------------------------------------------------------------------------------------
--------------------------------------------------------------------------------------------------------------------------------------------------------------------------------------------------------
--------------------------------------------------------------------------------------------------------------------------------------------------------------------------------------------------------
--------------------------------------------------------------------------------------------------------------------------------------------------------------------------------------------------------
--------------------------------------------------------------------------------------------------------------------------------------------------------------------------------------------------------
--------------------------------------------------------------------------------------------------------------------------------------------------------------------------------------------------------
--------------------------------------------------------------------------------------------------------------------------------------------------------------------------------------------------------
-------------------------------------------------------------------------------------------------------------------------------------------------------------------------------------------------------v
------oo-o--ooo--o------o------oo-o--o---o-o-oo--oo-----o-oo---oo-----o-----o----o-o-oo-----o-o---o---------oo-oo-----o-o-----------o---o--o-o-o---------o----------o--o-o--------------o----o---o-----f
------B-oM-MB-oBo-B?-?-o--ooBM-oB-o---BM-Bo-?o-o-?B----MB--o-BoM----B?ooo-B-o---?-o???--oo-B---o-oB-M---?M-MoM----o?-?--?-o---o-?o-o-o-?---------M-?--o-B-oM----B---B-o---o--oM-o?-oM-o-BBo--o?oMB-----f
------?----o--Mooo-?-?---M-o?-Mo--o-ooB--o-?M--Mooo-Mo--oM---B-o------o---o-BoMM-?-M---?-o-?o---BoB?----oBM-Bo-------------B-M--B--Boo-o-o-----B------o---o---oo-o--M-oMoo-oM--oBo?-M--o-----MM?M------f
----------oB---M--MoM---------B--o-T-M?M?-BoTooM--M-MBB--TM---o-ooTo-oo--ooBo-ooo-M--o--ooo-Bo-M----T--oo--o--T-oB------o---o------?o----?--TBo-M-To--oo?----o----B-oB?---?oooo--o-o-o-oBT-----T-M-----f
---------oM-B-MoBBB-oT---o-?MM---Bo|--B---oo|oo-o-oT---M-|o---o---|--oo-oB---ooooB-Too-B-BB-M---o--o|-o-?---T-|o-B---M-o-------o---T-Mo-M---|?-M--|--?M?oo--------o------M----oo-o-M--oB-|oB-Bo|-------f
-------?--------T--M-|BB-----------|---?--MM|MB-M--|-----|--B-----T-----T------M--MT----?--------TMM|--M----|-|---BM---------B-----|M-------|T-M--|-M--T-----T-BT------------TM--B-?----?|--BTM|-------f
mEE-EEE---------|-E-E|--E--E-------|-EEE----|---E--|E--E-|----EE--|--E--|--E-----E-|-E-----------|--|----E--|-|-EE--------E--------|--------||--E-|----|---E-|--|------E---E-|----E-----E|---|-|-------X
XXXXXXXXXXXXXXXXXXXXXXXXXXXXXXXXXXXXXXXXXXXXXXXXXXXXXXXXXXXXXXXXXXXXXXXXXXXXXXXXXXXXXXXXXXXXXXXXXXXXXXXXXXXXXXXXXXXXXXXXXXXXXXXXXXXXXXXXXXXXXXXXXXXXXXXXXXXXXXXXXXXXXXXXXXXXXXXXXXXXXXXXXXXXXXXXXXXXXXXX
