--------------------------------------------------------------------------------------------------------------------------------------------------------------------------------------------------------
--------------------------------------------------------------------------------------------------------------------------------------------------------------------------------------------------------
--------------------------------------------------------------------------------------------------------------------------------------------------------------------------------------------------------
--------------------------------------------------------------------------------------------------------------------------------------------------------------------------------------------------------
--------------------------------------------------------------------------------------------------------------------------------------------------------------------------------------------------------
--------------------------------------------------------------------------------------------------------------------------------------------------------------------------------------------------------
--------------------------------------------------------------------------------------------------------------------------------------------------------------------------------------------------------
-------------------------------------------------------------------------------------------------------------------------------------------------------------------------------------------------------v
---------oo-------------------o-----------------o--o-o------------o------o------o-----oo-----------o-------o-ooo-o-o----------------o--o-------o---o-------------------o---oo---o------------oo-o------f
------B--o--?Mo---?-o-B-oo-?Moo--B??----?-B-----o-o----B-------o-?---------Bo-B--B-----oM----o---B------?-o-----oM-B--BM---?-oBoo-?-BB-M?-M--M?--BooM----B-M?-o?-----------?-o-o----o--B---Bo-Bo-o-----f
-----------?MM--ooo--o-----B-B-B-----B---oo--oB---o---------?----oM----oM-M---------o---o--?-B-------o-M--o---Bo-M-----o---o------o---o-o----B--o--o----Bo----B-M--?o---B----o----o----o----?---o------f
------?B-o-----?B?--B-o-o--o----o--??o-B--oB-oM-M?----------o---o--oTM-----M--o----o-----o---Mo--?--o-MT-----M-----ooT---oo---o-o-M?----------TB-------Bo-oM--Moo-To-?--o--oo--M-o?-o-?--B?--oM--------f
---------B--Bo----o--M-------Boo------B-oT--M?----BM--T--To--o---B--|----o-----o?-----oo-o-o-?-T-T-----|----M--o---o-|-----M-B-B?---T----?----|--?--oo---M--------|-----o---------M--M---o--o--ToM-----f
--------M-----------M--------------------|-------B---M|--|---M-B----|T----T----B-?-----B-------|-|-----|?------?-----T----------M---|---M-M-?-|---B-------------T-|----M---?--MBBT-B---M-----?-|-------f
m-E-EE-EE------E--E------E---EE--E-E-E--E|---E-EE-E--E|--|-E---E----||E---|---EEE----------E-E-|-|--E-E|---------E---|E-E--E----E---|E-E------|EE---E----EE-----|-|----E-E--E----|--EEEEE---E--|EEE--EEX
XXXXXXXXXXXXXXXXXXXXXXXXXXXXXXXXXXXXXXXXXXXXXXXXXXXXXXXXXXXXXXXXXXXXXXXXXXXXXXXXXXXXXXXXXXXXXXXXXXXXXXXXXXXXXXXXXXXXXXXXXXXXXXXXXXXXXXXXXXXXXXXXXXXXXXXXXXXXXXXXXXXXXXXXXXXXXXXXXXXXXXXXXXXXXXXXXXXXXXXX
