--------------------------------------------------------------------------------------------------------------------------------------------------------------------------------------------------------
--------------------------------------------------------------------------------------------------------------------------------------------------------------------------------------------------------
--------------------------------------------------------------------------------------------------------------------------------------------------------------------------------------------------------
--------------------------------------------------------------------------------------------------------------------------------------------------------------------------------------------------------
--------------------------------------------------------------------------------------------------------------------------------------------------------------------------------------------------------
--------------------------------------------------------------------------------------------------------------------------------------------------------------------------------------------------------
--------------------------------------------------------------------------------------------------------------------------------------------------------------------------------------------------------
--------------------------------------------------------------------------------------------------------------------------------------------------------------------------------------------------------
-------o--------o-------o------o----o--o-------o------o------o-o---oo----o--o-----o------ooo--oo----o----------------------o------o-o---oo-o-o----o-o-----o---o-o-----oo-oo----o--o-----o-----o---------
-------o?ooo?o--M---oM-B-----oo-?----M?M-?-B----oBB------?------o---B-B----o--?Bo---o---o-??-B----o-??-?-?-----M---o?-----?-Bo-B---o-----oooB----B-------?-?-o----?--o--oB--oo?-?---o---oBoM-o----------
-----------ooBo----?----oM----M-oo--oo-B--o--o----o------o--Mooo---o------------o--------------?----o-----o--o-o-o?-oBB-------o-o------M----------o----B---o---------MM-o--M-?-o---M----------oo--------
-------?------o--o--?--o-M--o-----------o-oT-oo-----o-T------------B-o----o------o-o--------o------T------?-M-o-?B-o-M---?o--M---o-----------------o-o-M---?o-o-----?oo----------?----?-----T-----------
-------?---oo---o--o-----------------------|-M----o-o-|--------T-o---M--B?-o-------o---------o----B|v--M----B---o-o---o--o-?-B---oo--?---B--oBo-o-----T-o-----o--------------B--?-----o--T-?|---o-------
--------B------BT----------?-B?---------MM-|----B-T---|-B---B--|?M------------?------------?-------|f----?--?--------M-M---------------MB---M-M-------|----T---T---------M---T-T-------M-|--|-----------
m----E----------|-----------E----E---------|------|---|--------|E-----------------------------E----|f-----E-------------E-------------E---------------|----|---|-------------|-|---------|--|-----------
XXXXXXXXXXXXXXXXXXXXXXXXXXXXXXXXXXXXXXXXXXXXXXXXXXXXXXXXXXXXXXXXXXXXXXXXXXXXXXXXXXXXXXXXXXXXXXXXXXXXXXXXXXXXXXXXXXXXXXXXXXXXXXXXXXXXXXXXXXXXXXXXXXXXXXXXXXXXXXXXXXXXXXXXXXXXXXXXXXXXXXXXXXXXXXXXXXXXXXXX
