--------------------------------------------------------------------------------------------------------------------------------------------------------------------------------------------------------
--------------------------------------------------------------------------------------------------------------------------------------------------------------------------------------------------------
--------------------------------------------------------------------------------------------------------------------------------------------------------------------------------------------------------
--------------------------------------------------------------------------------------------------------------------------------------------------------------------------------------------------------
--------------------------------------------------------------------------------------------------------------------------------------------------------------------------------------------------------
--------------------------------------------------------------------------------------------------------------------------------------------------------------------------------------------------------
--------------------------------------------------------------------------------------------------------------------------------------------------------------------------------------------------------
---------------------------------------------------------------------------------------------------------------------------------------------------------------------------------------------------v----
------------o---------------------------------------o----------------------------------------------------------------------------------------------------------------------------------------------f----
-------------------------o-------o----------------o---------------------------------------------------------------------------o-----o--------------------------------------------------------------f----
------------------------------------------------------------------------Mo--o---------------------------------------------------------------------M---------------------------o--------------------f----
---M-------------------------------------------------------B-----o------------o--------------------------?------------?-------------------------------------B--------------------------o----------?f----
-------------M---------------------M---o-----M----------------------------------------------------o----o-----------------------------o-------------------------------------------------------------f----
---------------------------------------------------------------------------------------------------------------------------------------------------------------------------------------------------f----
m--------------------------------------------------------------------------------------------------------------------------------E--------------------------E--------------------------------------X----
XXXXXXXXXXXXXXXXXXXXXXXXXXXXXXXXXXXXXXXXXXXXXXXXXXXXXXXXXXXXXXXXXXXXXXXXXXXXXXXXXXXXXXXXXXXXXXXXXXXXXXXXXXXXXXXXXXXXXXXXXXXXXXXXXXXXXXXXXXXXXXXXXXXXXXXXXXXXXXXXXXXXXXXXXXXXXXXXXXXXXXXXXXXXXXXXXXXXXXXX
