--------------------------------------------------------------------------------------------------------------------------------------------------------------------------------------------------------
--------------------------------------------------------------------------------------------------------------------------------------------------------------------------------------------------------
--------------------------------------------------------------------------------------------------------------------------------------------------------------------------------------------------------
--------------------------------------------------------------------------------------------------------------------------------------------------------------------------------------------------------
--------------------------------------------------------------------------------------------------------------------------------------------------------------------------------------------------------
--------------------------------------------------------------------------------------------------------------------------------------------------------------------------------------------------------
--------------------------------------------------------------------------------------------------------------------------------------------------------------------------------------------------------
--------------------------------------------------------------------------------------------------------------------------------------------------------------------------------------------------------
--------o-----o-------o---o-------------------------------o-o----o-------------------------o-----------------o-o----------------------o----------------o-o------o---o------------------o--o-------------
--------B----o---o--?o-M-o-o----oB-----o-B-?Mo--------o--B---B---?----ooB----o--B---o-----M-?----o--o-o--M-----B----?o-?--------o--o-----?-o----------?--B-?--?---?--?-?o-oo-----------o---?------------
--------o--?o--?----------------o-------------o-o---M--o--------o-oMo--------o-----o----------M--oo-B--------?B-------?-----B---o----------------o--o--------o-----oo----o------Mo--v-------o-----------
----------o----o--oo-------oMo-B----o--o----------o-----B------o--------?---o---------o---o---------------?---?----??-----To--------o-o--------B-MB----T--oo---B-------o------?oo-B-f------M--o--o------
----------o---o--T-T----o--o--o--?T--MoMo--T----oo-?----oMo-?-B--o-------Bo------------Boo---?-?-T-----oo-o---ooB---o----o|-------oo---------B?--------|------oo-o--o-----o-o-o--o--f---------oo--------
---------M-------|-|---------BT---|-M------|-----------M---T------B-----?------------------------|--------------------MM--|----T-?----M-B?-M---------T-|------------------------?---f------------?------
m-------E------E-|-|---E------|-E-|------E-|-------E-------|-E---------------E-------------------|-------------E----------|-E--|--------E----E----E--|-|------E-------E-------------fE-----E------------
XXXXXXXXXXXXXXXXXXXXXXXXXXXXXXXXXXXXXXXXXXXXXXXXXXXXXXXXXXXXXXXXXXXXXXXXXXXXXXXXXXXXXXXXXXXXXXXXXXXXXXXXXXXXXXXXXXXXXXXXXXXXXXXXXXXXXXXXXXXXXXXXXXXXXXXXXXXXXXXXXXXXXXXXXXXXXXXXXXXXXXXXXXXXXXXXXXXXXXXX
