--------------------------------------------------------------------------------------------------------------------------------------------------------------------------------------------------------
--------------------------------------------------------------------------------------------------------------------------------------------------------------------------------------------------------
--------------------------------------------------------------------------------------------------------------------------------------------------------------------------------------------------------
--------------------------------------------------------------------------------------------------------------------------------------------------------------------------------------------------------
--------------------------------------------------------------------------------------------------------------------------------------------------------------------------------------------------------
--------------------------------------------------------------------------------------------------------------------------------------------------------------------------------------------------------
--------------------------------------------------------------------------------------------------------------------------------------------------------------------------------------------------------
-------------------------------------------------------------------------------------------------------------------------------------------------------------------------------------------------------v
------o-------o-----------o---o-----o---------o---o----o--oo--------------oo-----o---o-------o-o---o-o---o---o-o------------------------o---oo-o-------o----------o------o----oo---------oo--oo--------f
---------B-oM?--M----Bo-------o?oM--------M-o-Bo-M-?--B-oB--M-B---------?--o-----?oB--M--Boo-oMBo---?o-BoB--?M?M-B-?-o?--o--o---BM-o--B-Bo-?B-oo-o--o--B----------B-oM-----Boo--BM-o------BM-----------f
-------?------Bo-o-B-o----o-----------o----BM-?o-oo-oB??o--o--o--M-----oo--o---B--o---M?---o-?-----M-----o----o-------?--------M?-M-oooo---M-B---o--o-----oo--oo-o?M------M---o---------o--o--B?-o-----f
-------------?------------------BM---?M---o--o----o----o--M--o---o----o-M-oB-----B---?-oBoo---?-o?B-------o--o--o-oo-Mo?-o-o---oB--oMo---Bo-Moo-Mo---o--B--o---M--?-M--Bo---o-?---??-B?M--o--?--o------f
------oMB---B-T-o----B?---M--oo--T--MB-oM--o---o?MM-?M---?--o-?-o--o-B-o---o-o--o------T----T?-----------B?oB?-o---o-oB------o----BT-o-MoBMo---ooo-------o--M----o---o----------o-ooo------MB---o------f
-----------MB-|-M--------M-?-----|---M-M-----MTM?-B--M---B----T----M---M------------M--|M-B-|-----------------T-B----M--------M----|?MM--?-------M--T-TTM-----?-M-------------------MB--B--TB----------f
m-E--E---E-E--|E-E--E----T--EEEET|E-E--T--E--E|----E----------|------E-E--------E------|----|----E-E-EE------E|T-EE--EEET----------|E---ET--E-E-----|-||--E--------E-------EE-E-----E-E-E--|E---E--E---X
XXXXXXXXXXXXXXXXXXXXXXXXXXXXXXXXXXXXXXXXXXXXXXXXXXXXXXXXXXXXXXXXXXXXXXXXXXXXXXXXXXXXXXXXXXXXXXXXXXXXXXXXXXXXXXXXXXXXXXXX|XXXXXXXXXXXXXXXXXXXXXXXXXXXXXXXXXXXXXXXXXXXXXXXXXXXXXXXXXXXXXXXXXXXXXXXXXXXXXXX
