--------------------------------------------------------------------------------------------------------------------------------------------------------------------------------------------------------
--------------------------------------------------------------------------------------------------------------------------------------------------------------------------------------------------------
--------------------------------------------------------------------------------------------------------------------------------------------------------------------------------------------------------
--------------------------------------------------------------------------------------------------------------------------------------------------------------------------------------------------------
--------------------------------------------------------------------------------------------------------------------------------------------------------------------------------------------------------
--------------------------------------------------------------------------------------------------------------------------------------------------------------------------------------------------------
--------------------------------------------------------------------------------------------------------------------------------------------------------------------------------------------------------
-------------------------------------------------------------------------------------------------------------------------------------------------------------------------------------------------------v
---------o--ooo---oo------o-o---o---o----------o--------o---o-oo-------oooo-----o-----------------o--o-----o--o--o-o--oo--------o-------o-o-oo-o--------oo-----o--o---oo---------o-o------oo-oo-oo-----f
------?M-B--oBo----B-B--Bo---Mo?B-?---o--o--o?----oM?M-?-?oMo-MBB-oo?o-B-oo---?-?o-oo-M-B-o--M----o--?o-?B-----B-B-o---o?-o--oo-BM-o-B--Bo--B-o--o-B-ooB-Moo----ooBo-o-MoB?--?----MoBB--oo?M-M-MBM-----f
---------o--?M?oo--B?-----o--------BB---B--B--?-------o-ooo-oBM-o---MM-o-----M----oo-o---B---o---o----o-oo-oooBo-BB--?oBoM?MB--M?-M-oooo---M-B---o-M-oo-o--B--M---o?-M--oB-o---o-ooBo-oBMo?---ooBo-----f
--------B----M-BooM-o-------?oMB-M-o-?---oo-----o--oo--oMo-o-MB-oo-oB-M---oo------?-o--B-BM-o---o--oM--?----o?--Booo------Bo--oo---oM----Bo-M-o-Mo-oo?--ooo-MM-?-oBo----o-o-o--oo--o---o--Mo--?-Bo-----f
--------B---Mo-ooo--T---oo---ooo-T-oo--?o--oMMT--M--o-----To-M----M?-oBB-o---T--oM--o-?TT--BBM-Too?--BooB---o-M?-BM-?T--ooo??o----BT-o-MoBMo---ooo-oo--oT?MM--?----M---o?-o--o-o-MMoB?--?ooMT--M-T-----f
--------M--M-B------|--M-M-------|----T-------|-?-?-M-?TT-|--M-M---M----MB-?-|--------B||------|-M-B-?----B-------T--|-----T-B-----|?MM--?--B----M-B-M--|-------?-M--------T--B--?---?-M?-B-|-?--|-----f
mEE-E-E----EE-E-E--E|E-----E--EET|--E-|--E-T--|-------E||-|EE-T-E---TEEE----E|--E--E---||-E--E-|E------ET---------|-E|-E---|-E----E|E----T--E-E----E---T|-------T--E--EE--E|-EE-EE---T-ETET-|-E-E|E-EEEX
XXXXXXXXXXXXXXXXXXXXXXXXXXXXXXXXXXXXXX|XXXXXXXXXXXXXXXXX|XXXXXXXXXXX|XXXXXXXXXXXXXXXXXXXXXXXXXXXXXXXXXXXXXXXXXXXXXXXXXXXXXXXXXXXXXXXXXXXXXXXXXXXXXXXXXXXXXXXXXXXXXXXXXXXXXXXXXXXXXXXXXXXXXXXXXXXXXXXXXXX
