--------------------------------------------------------------------------------------------------------------------------------------------------------------------------------------------------------
--------------------------------------------------------------------------------------------------------------------------------------------------------------------------------------------------------
--------------------------------------------------------------------------------------------------------------------------------------------------------------------------------------------------------
--------------------------------------------------------------------------------------------------------------------------------------------------------------------------------------------------------
--------------------------------------------------------------------------------------------------------------------------------------------------------------------------------------------------------
--------------------------------------------------------------------------------------------------------------------------------------------------------------------------------------------------------
--------------------------------------------------------------------------------------------------------------------------------------------------------------------------------------------------------
----------------------------------------------------------------------------------------------------------------------------------------------------------------------------------------------v---------
--------o-----oo----------o----o-------o-------o---o-o---------------o------o-o--------o-----o---o--o----o--------------o------o--------o-------o------o----------o-------------o-------------f-o-------
-------o--------oo---M?--o-B-----B----------B-----------?o------?---o-B-----o-B-o-o----o----Mo-o-?------o?--M-?------------oo-Bo--------o--?----o-------oo---o----------?---------B-----------fB--------
---------Bo-------------o-o-o--------?-o------Mo-?o--B-M-------Mo-------o---Boo----------?--B-o--?--?o--?M--o--------?---o---o----M-----M---------?-------B-----B---o------?-----------o------f--M------
----------o--------o---?---B---------B------oBoo------o---M-----o-To-----o-?----o--oT------o-------o------o--T--o-------------T-o---o------T--o?o----------------T-o----o---M----B-------?----f--o------
---------?-----B---T-------------------o--------o-----T--o---B?---|-----T-----M-----|M---o---------ooo------M|---T-o--------M-|--------M-T-|---o-o---o----B--M---|-?--------T-----------------f---------
-------------------|-------?-----T--------?-------T---|---------?-|-----|-----------|----------T---B---------|---|-BMT--M---MM|?---T-----|-|--M------------------|----------|-----MMB-------?-f---------
m-----E--------E---|-------------|----------------|---|EE---E-E---|-----|-----------|E-E-------|-----------E-|---|---|--------|----|-----|-|-E-E-----------------|----E-E---|--E------E-E----EX---------
XXXXXXXXXXXXXXXXXXXXXXXXXXXXXXXXXXXXXXXXXXXXXXXXXXXXXXXXXXXXXXXXXXXXXXXXXXXXXXXXXXXXXXXXXXXXXXXXXXXXXXXXXXXXXXXXXXXXXXXXXXXXXXXXXXXXXXXXXXXXXXXXXXXXXXXXXXXXXXXXXXXXXXXXXXXXXXXXXXXXXXXXXXXXXXXXXXXXXXXX
