--------------------------------------------------------------------------------------------------------------------------------------------------------------------------------------------------------
--------------------------------------------------------------------------------------------------------------------------------------------------------------------------------------------------------
--------------------------------------------------------------------------------------------------------------------------------------------------------------------------------------------------------
--------------------------------------------------------------------------------------------------------------------------------------------------------------------------------------------------------
--------------------------------------------------------------------------------------------------------------------------------------------------------------------------------------------------------
--------------------------------------------------------------------------------------------------------------------------------------------------------------------------------------------------------
--------------------------------------------------------------------------------------------------------------------------------------------------------------------------------------------------------
---------------------------------------------------------------------------------------------------------------------------------------------------------------------------------------------------v----
------------------------------------------o--o-----------------------------------------------------------------------------------------------------------------------------------------------------f----
-------------------------------o-----------------------------------o-------------------------------------------------------------------------------------------------------------------------------f----
------------------------o-------------------------------o-------------------------------------o---o---o---------------o---------------------M------------------------M-----------------------------f----
--B----------------------------------------------------------?--------------------o----------------------------------------------TT-----------------------------------------------------------?----f----
--------------------M--------------------?-----------------------------------------------------------M---------------------------||----------------------------------------------------------------f----
---------B-------------------------------------M---------------------------------------------------------------------------------||----------------------------------------------------------------f----
m-----------------------------------E--------------------------------------------------------------------------------E-----------||----------------------------E-------------E---------------------X----
XXXXXXXXXXXXXXXXXXXXXXXXXXXXXXXXXXXXXXXXXXXXXXXXXXXXXXXXXXXXXXXXXXXXXXXXXXXXXXXXXXXXXXXXXXXXXXXXXXXXXXXXXXXXXXXXXXXXXXXXXXXXXXXXXXXXXXXXXXXXXXXXXXXXXXXXXXXXXXXXXXXXXXXXXXXXXXXXXXXXXXXXXXXXXXXXXXXXXXXX
