--------------------------------------------------------------------------------------------------------------------------------------------------------------------------------------------------------
--------------------------------------------------------------------------------------------------------------------------------------------------------------------------------------------------------
--------------------------------------------------------------------------------------------------------------------------------------------------------------------------------------------------------
--------------------------------------------------------------------------------------------------------------------------------------------------------------------------------------------------------
--------------------------------------------------------------------------------------------------------------------------------------------------------------------------------------------------------
--------------------------------------------------------------------------------------------------------------------------------------------------------------------------------------------------------
--------------------------------------------------------------------------------------------------------------------------------------------------------------------------------------------------------
-------------------------------------------------------------------------------------------------------------------------------------------------------------------------------------------------------v
---------o--ooo---oo------o-o---o---o----------o-o------o---o-oo-----o-oooo-----o--------------o--------o----oo--------o----o-----------o---oo-o--------oo----oo--o---oo---------o-o------oo-oo-oo-----f
------?M-B--oBo----B-B--Bo---Mo?B-?---o--o---?----oM?M-?-?oMo-MBB--o?o-B--o-M-?M?o-oo-M-B-o--M?-?-oM-?oM--B---M?o-o-o?-o?-o--oooBM-o----BoB-B-o--o-B-ooB-Moo----ooBo-o-MoB-B-?----MoBB--oo?M-M-MBM-----f
---------o--?M?oo--B?-----o--------BB---B--BB-?-------o-ooo-oBMMo---MM-o--o--M-----o-o---B---o-M--M--oooo?B--o--o-o--o-BoM?M---M?-M-oooo---M-B---o-M-oooo-----M-?-o?-M--ooo----o-ooBo-oBMo?---ooBo-----f
--------B----M-BooM-o---o---?oMB-M-o-?---ooM----o--oo-BoMo-o-MB-oo-oB-M---oo------?oo--B-B-Bo--B-o----MM-o-Mo------oo-M-B--o--oo---oM-----o-M-o-Mo-oo?-?ooo-MM-?ooB-----o-oBo-Moo-Bo---o--Mo--?-Bo-----f
--------B---Mo-ooo--T---oo---ooo-T-oo--?o--oMMT--M--o-----To-M----M?-oBB-o---T--oMoTo-?-T--BBMo-o--o--oB-B----?---oo-Mo--Mo??o----BT-o-MoBMo--Tooo-oo--oT?MMo-?----Mo--o?--o-oBo-MMoB?--?ooMT--M-T-----f
--------M--M-B---B--|--MTM--?----|----T-------|-?-?-M-?T?-|--M-MM--M----MB-?-|-----|--B-|----------B-------?-?-------T-B---T-B-----|?-M--?----|----B-M-M|--B----?-M----B------B--?---?-T?-B-|-?M-|-----f
mEE-E-E----EE-E-E--E|EE-|E-EE-EET|--E-|--E-T--|-------E|--|---T-E----EE-----E|--E--|---E|----E-------------E-E---T---|-EEE-|-E---E-|E----T--E-|------E-T|-------T--E--EE-----EE-EE---T-|TETE|-E-E|EEEEEX
XXXXXXXXXXXXXXXXXXXXXXXXXXXXXXXXXXXXXXXXXXXXXXXXXXXXXXXXXXXXXXXXXXXXXXXXXXXXXXXXXXX|XXXXXXXXXXXXXXXXXXXXXXXXXXXXXXXXXXXXXXXXXXXXXXXXXXXXXXXXXXXXXXXXXXXXXXXXXXXXXXXXXXXXXXXXXXXXXXXXXXXXXXXXXXXXXXXXXXXX
