--------------------------------------------------------------------------------------------------------------------------------------------------------------------------------------------------------
--------------------------------------------------------------------------------------------------------------------------------------------------------------------------------------------------------
--------------------------------------------------------------------------------------------------------------------------------------------------------------------------------------------------------
--------------------------------------------------------------------------------------------------------------------------------------------------------------------------------------------------------
--------------------------------------------------------------------------------------------------------------------------------------------------------------------------------------------------------
--------------------------------------------------------------------------------------------------------------------------------------------------------------------------------------------------------
--------------------------------------------------------------------------------------------------------------------------------------------------------------------------------------------------------
-------------------------------------------------------------------------------------------------------------------------------------------------------------------------------------------------------v
------o--o--oo---o-----o---------------o--o--o-----------------o--o--------------oooo--------------------o-o-----o--o------------o--------------oo------o--oo-o-o--------o---------oo-o---o------o-----f
--------o-?B-B??oo-o-o--o-?-ooo---?o------o-----o--o-o----B------o-o---?-B----------oBB----B-o-M--o?----o------B---o---?---Boo-o--o--oo?-o---M--o--?oo-------o--o-B----o?-B--ooB-M--ooM----B-----B-----f
-------M---?-Mo--oo-BB?MM---o-?o--o?B-?----?o---oo-Mo-----o-o--------oBoo----------M-------o-B--------?-o-o---o-M-?o-oo----?----o-ooBo----MMM--------o-?o-B------o-M--o--?--------?M--MM-------B-------f
-------o-oM--M---o----M-oBBo?----o--o----?-Bo----M-o----------B---?--?---B--o-o--o----M--M-TT?-M?oBTT-BMo-?o----o---o--o-B--?---o--------TT---oB---M--MM--MM--o--Mo-------o-?--------oo?-----MB-o------f
--------oo----oB-?oo--?oo----?---o--?o--o---TT------------?--B---o------o------o-M----TT---||M-----||B-?----?oo---------?-oB----BM------M||-------?--TT-------o------------o----o---o--M-?--TT-Too-----f
------M-?B----?--M---?-M--------------------||----------TT---------?------TT---?--M---||-M-||-M----||---------------?----------B---------TT-M--B-----||------------?-----------MTT?---MB--BM||-|-------f
mEEEEE--E-----EE--E-------E---E------------E||----E-----||---------------E||------E--E||---||------||---E------E---------------E--E------||--------E-||E--E-------EE----------E-||-----E---E||-|---E--EX
XXXXXXXXXXXXXXXXXXXXXXXXXXXXXXXXXXXXXXXXXXXXXXXXXXXXXXXXXXXXXXXXXXXXXXXXXXXXXXXXXXXXXXXXXXXXXXXXXXXXXXXXXXXXXXXXXXXXXXXXXXXXXXXXXXXXXXXXXXXXXXXXXXXXXXXXXXXXXXXXXXXXXXXXXXXXXXXXXXXXXXXXXXXXXXXXXXXXXXXX
