--------------------------------------------------------------------------------------------------------------------------------------------------------------------------------------------------------
--------------------------------------------------------------------------------------------------------------------------------------------------------------------------------------------------------
--------------------------------------------------------------------------------------------------------------------------------------------------------------------------------------------------------
--------------------------------------------------------------------------------------------------------------------------------------------------------------------------------------------------------
--------------------------------------------------------------------------------------------------------------------------------------------------------------------------------------------------------
--------------------------------------------------------------------------------------------------------------------------------------------------------------------------------------------------------
--------------------------------------------------------------------------------------------------------------------------------------------------------------------------------------------------------
--------------------------------------------------------------------------------------------------------------------------------------------------------------------------------------------------------
------------o---------------o--------------o--o---------o--------o------------o--o---o--------oo-------o----o---------o--o-----------o--o------------o---------------o--------------o------------o------
--------?-----o-M--o--o-----?----?o----o--?-o------oM-o-o?------B--o---B----o---o-B----o-o-M----M-M---oo---B-------?B---M-o--------o?o-o-o-M--o----o-B-B--o--M---MBo-----?o----------------?------------
---------o?o------------o-o--o--------------o-ooo--o-----?--------o-------oo------------------BoBB--Mo----??---?o--M----Bo-------oo-----?------------o------?----------B--o-o-o---M-----o--------o------
-------oB-o-----?o----o-------BM-?o----o---oB--o------oo--o----oo-M----o---BoM-Moo---T---o--o---oo----?--o-----o--o-oo------o-B--o---?-------oo--T----------T-------------o-M------B-?--o-------o-------
v---------?--To-------------?-----o---o----o-MoT-----T------T----?----?ooT-T-----o---|-T----B---o----o-----B-T--o------o---?---B-----------To----|---Bo----o|-o----M---T------o---T-----------T?--------
f------------|M----B----------M--------------M-|--B--|------|------?--B--|-|--M------|-|-M-------------------|------M----T-M--?------------|-----|-------T--|---------T|--------M-|--------T--|---------
f---E-----E--|-------------------------------E-|-E---|------|------E-----|-|---------|-|-----E---------------|-----------|----------E-EE---|-----|---E---|--|---------||--E---E---|E-------|--|---E-----
fXXXXXXXXXXXXXXXXXXXXXXXXXXXXXXXXXXXXXXXXXXXXXXXXXXXXXXXXXXXXXXXXXXXXXXXXXXXXXXXXXXXXXXXXXXXXXXXXXXXXXXXXXXXXXXXXXXXXXXXXXXXXXXXXXXXXXXXXXXXXXXXXXXXXXXXXXXXXXXXXXXXXXXXXXXXXXXXXXXXXXXXXXXXXXXXXXXXXXXX
