--------------------------------------------------------------------------------------------------------------------------------------------------------------------------------------------------------
--------------------------------------------------------------------------------------------------------------------------------------------------------------------------------------------------------
--------------------------------------------------------------------------------------------------------------------------------------------------------------------------------------------------------
--------------------------------------------------------------------------------------------------------------------------------------------------------------------------------------------------------
--------------------------------------------------------------------------------------------------------------------------------------------------------------------------------------------------------
--------------------------------------------------------------------------------------------------------------------------------------------------------------------------------------------------------
--------------------------------------------------------------------------------------------------------------------------------------------------------------------------------------------------------
-------------------------------------------------------------------------------------------------------------------------------------------------------------------------------------------------------v
-------o--------------o----ooo--o-------oo-o-o----o------------------o-o-o---o------o----o--------o----o-----o----o-----o-------------------o-----o-oo--o-o-o-o--oo--o----o---o---o------o--oo-o-------f
------?-------o--BMoo-M-Bo---?-oo???o------o?o---B--oB-----o-B-o----B?-B-oo-o----Bo--M?-o--Bo-----B-o---?-----B--o---?--?-o-----?--o-M-------B--o-?-oBo-M-oB-o--?--M--?ooMMo??Bo----?BM-----o---BM-----f
------ooo-o-oo---?-?--?--M--ooo-----Mo-------oB-o--B-----B-B-Boo--o---o------oM----oo--o-------oooB?--o---M--o---o---------B-M-----Boo---oo-?--o-o--M---o-?Moo--ooMo-o----M-o-M-o-o-?------?-o--B------f
-------oo-----oMT---M--o-oT----?o-----M?M--o------oT-o--B--oT------MooB-o-o?--o-?-----o-----B--M--------o--ooMoo--------o---o-----o?o----?o-o----M-?-?-oooo?--?---M---o--o--M--ooooM------Mo--?-T------f
------o---B--ooT|--o-o-o--|To----oM-MB--M---B-oMoB-|-Bo-M-oMT-oo-----Mo-?-ooMo-o---??o-M-TB---ooooBo--B--T-----------M---------o---T-Mo-M--M------B----------M-o-------oB-oBM---?oM------o?-Bo-o|------f
-------------?-||---?-----||-----M--T-B----M-------|---?BM--|-----?-M?T-?---T-------T---B|----------M--M-|-------T-----------B--B--|------MT--------------B-T-B--T----TMT-M------B----?--M------|M-----f
mEE-EE-E-E---EE||E--E----E||----E---|-E---EE---EE--|--------|--EE----E|-E---|-------|----|---------------|-------|--E-----E--------|-------|-------E--------|-E-E|E--E|-|-------------E---------|------X
XXXXXXXXXXXXXXXXXXXXXXXXXXXXXXXXXXXXXXXXXXXXXXXXXXXXXXXXXXXXXXXXXXXXXXXXXXXXXXXXXXXXXXXXXXXXXXXXXXXXXXXXXXXXXXXXXXXXXXXXXXXXXXXXXXXXXXXXXXXXXXXXXXXXXXXXXXXXXXXXXXXXXXXXXXXXXXXXXXXXXXXXXXXXXXXXXXXXXXXX
