--------------------------------------------------------------------------------------------------------------------------------------------------------------------------------------------------------
--------------------------------------------------------------------------------------------------------------------------------------------------------------------------------------------------------
--------------------------------------------------------------------------------------------------------------------------------------------------------------------------------------------------------
--------------------------------------------------------------------------------------------------------------------------------------------------------------------------------------------------------
--------------------------------------------------------------------------------------------------------------------------------------------------------------------------------------------------------
--------------------------------------------------------------------------------------------------------------------------------------------------------------------------------------------------------
--------------------------------------------------------------------------------------------------------------------------------------------------------------------------------------------------------
----------------------------------------------------------------------------------------------------------------------------------------------------------------------------------------------v---------
---------o-o--------o-----------------------o----oo----o-o----o-----------------------o-o------o-------------o---o-----------------o----o-----o-o------------o-o--o--o----o---o-------------o-f-o-------
-------?-----Bo-----?-----BM-o-o-o-----------MB-----B---------------?o-o----?---oB--Mo---o--?--M-oo---o-B------?-o---B-------?------------?--------?-------B-------o----o--BBoo-------B-----M-fo--------
-------B--------------B-oM----o----?o----o------------?----?Bo-MBoo-----Mo--oB------oM--B---o-o-----?---------M-------------------o---------o-o----M-----o----------------o----o--o--B--------fo-o------
-------o-----M-------o-----o--o-?---o-----B-----Mo-M-----o-?-o-----M-o--------oo-------------------?---o--o----M---T----oM----o?B--M--B-----o--------o-o-o-o---?-----B---o-o---M----o--o----Bof---------
--------M--B-o--MBoB--B------o--o---MM-oo-B----?----o------------o--MT-o-T--M---M-----?---------o-To-------T---Mo-o|------?-----------T---------o---M---o-T--M-o?-?--oM?--T---M---------?---?of-o-------
-----------------MB?-------------M--T------T------M----TB--M---------|--M|---------?----M--M------|----B---|---B---|?-----B-----?-----|----T---T----?-----|--------------M|--B--------T-------f---------
m-----------E----E-------------E----|---E--|-----------|-------------|---|--------E-----E--E------|------E-|-------|------------------|----|---|--E----E--|-------------E-|-----------|-----E-X-E-------
XXXXXXXXXXXXXXXXXXXXXXXXXXXXXXXXXXXXXXXXXXXXXXXXXXXXXXXXXXXXXXXXXXXXXXXXXXXXXXXXXXXXXXXXXXXXXXXXXXXXXXXXXXXXXXXXXXXXXXXXXXXXXXXXXXXXXXXXXXXXXXXXXXXXXXXXXXXXXXXXXXXXXXXXXXXXXXXXXXXXXXXXXXXXXXXXXXXXXXXX
