--------------------------------------------------------------------------------------------------------------------------------------------------------------------------------------------------------
--------------------------------------------------------------------------------------------------------------------------------------------------------------------------------------------------------
--------------------------------------------------------------------------------------------------------------------------------------------------------------------------------------------------------
--------------------------------------------------------------------------------------------------------------------------------------------------------------------------------------------------------
--------------------------------------------------------------------------------------------------------------------------------------------------------------------------------------------------------
--------------------------------------------------------------------------------------------------------------------------------------------------------------------------------------------------------
--------------------------------------------------------------------------------------------------------------------------------------------------------------------------------------------------------
---------------------------------------------------------------------------------------------------------------------------------------------------------------------------------------------------v----
--------------------------------------------o---------------------------------------------------------------------------------------------------------------------------------------o--------------f----
---------o-------------------o----------------------------o----------------------------------------------------------------------------------------------------------------------------------------f----
-o-------------?------------------------------------------------------------------------------------------M--------------------------------------------------------o-------------------------------f----
------------------------TT-------------------TT---------M----------------------o---------------------------------------------------------------------------------------M-------------M--------B----f----
------------------------||--o---o------------||-------o--------------------------------------------------------------------?-----------------------------------------------------------------------f----
-------?-------------?--||-------------------||--------------M------------------------B------------------------------------------------------------------------------------------------------------f----
m--E--------------E-----||---------E-----E---||---------------------E--------------------------------------------------------------------------------------------------------------------------E---X----
XXXXXXXXXXXXXXXXXXXXXXXXXXXXXXXXXXXXXXXXXXXXXXXXXXXXXXXXXXXXXXXXXXXXXXXXXXXXXXXXXXXXXXXXXXXXXXXXXXXXXXXXXXXXXXXXXXXXXXXXXXXXXXXXXXXXXXXXXXXXXXXXXXXXXXXXXXXXXXXXXXXXXXXXXXXXXXXXXXXXXXXXXXXXXXXXXXXXXXXX
