--------------------------------------------------------------------------------------------------------------------------------------------------------------------------------------------------------
--------------------------------------------------------------------------------------------------------------------------------------------------------------------------------------------------------
--------------------------------------------------------------------------------------------------------------------------------------------------------------------------------------------------------
--------------------------------------------------------------------------------------------------------------------------------------------------------------------------------------------------------
--------------------------------------------------------------------------------------------------------------------------------------------------------------------------------------------------------
--------------------------------------------------------------------------------------------------------------------------------------------------------------------------------------------------------
--------------------------------------------------------------------------------------------------------------------------------------------------------------------------------------------------------
-------------------------------------------------------------------------------------------------------------------------------------------------------------------------------------------------------v
---------oo-o-o----o------o-oo--o---------------oo---o--o--------o-------o-o-o---oo-o--------o---o----o-o-o-o-o--o----o---o-oooo--o-oo--o---------------------oo-o-----oo-o--oo---o-----oooo-o--o------f
------?M-B---Boo---B-Bo-oo----o?--o---o-?o---??------o--Bo-o-Mo-?o-?--ooM--?--?-?-?oMoo?MBo-B----BB--?oo?Moo?Moo-o---B--oo?-B-o-o-----oo-B?-o?-B--?MooBo----Boo---MB--o---M-BM-o--o----?o---oo-MB------f
---------o--?M?-o--B?-----o--------BB---B--B----?--BB----?B-?o--M--?------Bo---Moo-o----o--------??o---oM---B?B-o-oBM-o--MoMo--MBB--B-----B-M-B-?--oo---o-??-?oMo--BB---------M---?---o--------o-o-----f
--------B----M-BooM-o-------?oM--M-o-?-M-o----o--------oBoooM---M-MM----Mo-Bo--?o?o-M----o-B----o-Bo-M---MBo--oB-o------o--?oo--o-?oo---MoBB---o--------M-o?-o-o?---o---Bo--MoMM--M?---o----o??o-------f
-------oB-o-Mo-ooo--T-B-o----oo--T--o--?o--o-Mo--Mo-oM-o-TMoBooo--o------TM-oTo-oB-o---oo---o--ToT--oo-oT--o---o---?Mo-M-M--B-B--o-o-BTT---o----------T?MooM?M---M-MoTo-Bo---o?-oM-?o?-----M-M-M-T-----f
-------MM--M-B------|--M-M-------|--------------T-----T--|M---?M-B---?---|---|----?M-M-M-------|-|------|-B---M-----------?B-M-----MM-||------T-----TM|---BMM--M-T---|--M?-----?M-B-T?--?-B------T-----f
m-E-E-------E-E-E--E|E------E-EET|--E------TT---|-E--E|-E|-E--EE-E--E----|---|E-------E-E-TEE--|E|ET----|-E-E-EE-E--E-T-T--EET-EEE----||----E-|E----|E|EEE--EETE-|EE-|--EE--E-EEE---|--E---EE---E|EE-EEX
XXXXXXXXXXXXXXXXXXXXXXXXXXXXXXXXXXXXXXXXXXXXXXXXXXXXXXXXXXXXXXXXXXXXXXXXXXXXXXXXXXXXXXXXXXXXXXXXXXXXXXXXXXXXXXXXXXXXXXXXXXXXXXXXXXXXXXXXXXXXXXXXXXXXXXXXXXXXXXXXXXXXXXXXXXXXXXXXXXXXXXXXXXXXXXXXXXXXXXXX
