--------------------------------------------------------------------------------------------------------------------------------------------------------------------------------------------------------
--------------------------------------------------------------------------------------------------------------------------------------------------------------------------------------------------------
--------------------------------------------------------------------------------------------------------------------------------------------------------------------------------------------------------
--------------------------------------------------------------------------------------------------------------------------------------------------------------------------------------------------------
--------------------------------------------------------------------------------------------------------------------------------------------------------------------------------------------------------
--------------------------------------------------------------------------------------------------------------------------------------------------------------------------------------------------------
--------------------------------------------------------------------------------------------------------------------------------------------------------------------------------------------------------
--------------------------------------------------------------------------------------------------------------------------------------------------------------------------------------------------------
----------o--o-----o-o---o-o----------o-----oooo-------------------ooo----oo---o--oo-o----o---------------------o--------------oo-------oo----o----------o--o-o-----------o----oo--o----o---------------
-------?o------o--o----M?---Booo?--o------?-o--o--M--?o---------?---------?---?--------B----B-----------o-BM-oM?-o-Bo?---?-B-oB-B-o--M--?--o--o----?------Bo-B--oo------M?-------?-----------o----------
-----------B----o-----oo-----M-B--B-----oB----M-o-------B--oo------?--o-----?---oBo---------o---o-----o-oo----------------oM-------oo----o---o-o------------o-o-o--oo----?----o----MB--B----?-----------
---------o-B---ooB-o---B?oT---o-oT------M-B--o-----o-T-------Bo---------------o-------M-o--o--o-----o-oo-------------M---oo---o----oB?Mo----B----To---o-------oo--o----o--o--T?--oT-------?--T-B--------
-------o--o---o----M--M---|--o---|o?B-----?----o---T-|?-o------o----T-oM-----------o--T-?--?---o-o-------T--o--T------o--M-----o-Mooo----oT----?-|-o--v---B-------o-B---o----|o-oo|-----B---o|M-o-------
---------?---------?------|------|--------------B?M|-|---?M-T-T-----|--------------T--|-----------------M|-----|----------?---------------|--?---|-T--fT--B-------------M----|----|----------|----------
m---E---------------E---E-|----E-|-----------E--EE-|-|------|-|-----|E-------------|--|----E-------------|---E-|--------E-----------------|-----E|-|--f|--E---------E--E-----|----|----------|----------
XXXXXXXXXXXXXXXXXXXXXXXXXXXXXXXXXXXXXXXXXXXXXXXXXXXXXXXXXXXXXXXXXXXXXXXXXXXXXXXXXXXXXXXXXXXXXXXXXXXXXXXXXXXXXXXXXXXXXXXXXXXXXXXXXXXXXXXXXXXXXXXXXXXXXXXXXXXXXXXXXXXXXXXXXXXXXXXXXXXXXXXXXXXXXXXXXXXXXXXX
