--------------------------------------------------------------------------------------------------------------------------------------------------------------------------------------------------------
--------------------------------------------------------------------------------------------------------------------------------------------------------------------------------------------------------
--------------------------------------------------------------------------------------------------------------------------------------------------------------------------------------------------------
--------------------------------------------------------------------------------------------------------------------------------------------------------------------------------------------------------
--------------------------------------------------------------------------------------------------------------------------------------------------------------------------------------------------------
--------------------------------------------------------------------------------------------------------------------------------------------------------------------------------------------------------
--------------------------------------------------------------------------------------------------------------------------------------------------------------------------------------------------------
--------------------------------------------------------------------------------------------------------------------------------------------------------------------------------------------------------
-------o----o---o--------------o-----------o--o-o----o-----------oo----o-----------o-----o------o----------------------o------------------o-o----------o-------------o----o---------------------o-------
---------B-o-MM-----?--B----o--------Bo-MM---B---?o--o-----??----o--B----?----o-o-o-oo---?--o-----M-o-?-----B-B----M---o?-----B--B---------?-----?------?o----------?o--B---o-M----M--oo-?o-o-o--o------
-------MM--M--o--------------------o---M---------?---o--Boo------o?--------?o?--Bo--------M--B----o----o----M------------o----B----------B-----?-o--?------o--oo-----BMo-----?------o------------B------
----------------o-o----?-o-M--?o?-----?-------------o-------B-?-T-------o--oT--o-o------o--M--o--o--o-To-----o-o-o-MT---M--------o---?----oo---o--o------o-------B-T--o?--o---oo----B---?-o---T---------
-----------M--??-?--o---M?--MM------o-------T---------oo?Mo-oB--|----o------|-oBo----B--------o?oo----|---Boo-oo-Boo|-----------o------B------o---o---v----?-o-----|----oo-------o-o------oo--|--B------
--------B-?---------------------?--------?T-|-M------------M--B-|-----T---M-|T-B------T---M--------M--|------B-?----|----------?--B----------------T--f------------|?------?-----M------------|---------
m------E---------------------------E------|-|-------E-----------|-----|--E--||--------|---EE----------|-------------|-------------E-E----E---------|--f------E-----|--EE----------E-----------|-E--E----
XXXXXXXXXXXXXXXXXXXXXXXXXXXXXXXXXXXXXXXXXXXXXXXXXXXXXXXXXXXXXXXXXXXXXXXXXXXXXXXXXXXXXXXXXXXXXXXXXXXXXXXXXXXXXXXXXXXXXXXXXXXXXXXXXXXXXXXXXXXXXXXXXXXXXXXXXXXXXXXXXXXXXXXXXXXXXXXXXXXXXXXXXXXXXXXXXXXXXXXX
