--------------------------------------------------------------------------------------------------------------------------------------------------------------------------------------------------------
--------------------------------------------------------------------------------------------------------------------------------------------------------------------------------------------------------
--------------------------------------------------------------------------------------------------------------------------------------------------------------------------------------------------------
--------------------------------------------------------------------------------------------------------------------------------------------------------------------------------------------------------
--------------------------------------------------------------------------------------------------------------------------------------------------------------------------------------------------------
--------------------------------------------------------------------------------------------------------------------------------------------------------------------------------------------------------
--------------------------------------------------------------------------------------------------------------------------------------------------------------------------------------------------------
-------------------------------------------------------------------------------------------------------------------------------------------------------------------------------------------------------v
---------o--o-o----o------o-o---o------------o-o--------o---o-oo----oo-oooo-----o-------o---------------o----o------------o--------------oo-o-------o------oo-oo-o-----oo-o--oo---o------ooo-o--o------f
------?M-B---Bo----B-B---o---Mo?---B--o--o---?----oM?M-?-?oMo-MBB--o?o-B--o---?-?o-oo-M-B-o--M?-?-oM--oM--B---M?o-o-o?--?-o-Mo-BMoo-oo---M-o-?-B--?oooBo---oB?o?--MB--o---M-BM-o--o----?o---o--MB------f
------M--o--?M?-o--B?-----o--------BB?--B--B--?-------o-ooo-oBM-o---MM-o-----M----?o-o---B---o-M--M-?ooo-?B--o--o-o--o-----oMB--o----B------B-B-?--oo-----?M-?oMo--BB---------M---?---o--------o-o-----f
--------B----MoBooM-o-------?oM--M-o-?---oo-----o--oo--oMo-ooMB-oo-oB-M---oo------?-o--B-B--o---------MM-o--o------oo-M--M------oo?o-o----------o-------M-oM-oBo?--oooo-Bo--MoMM--M?---o----o??--------f
--------B---Mo-ooo--T---oo---oo--T-oo--?o-MoMMT--M--o-----To-M----M?-oBB-o---T--oM--o-?-T--BBMo-o--o--oB-B----?---oo-M-?o---?-------MM--?---?---------T?Moo--Moo-M---TooBo---o?-oM-?o?-----M---M-T-----f
--------M--M-B------|--M-M-------|------------|-?-?-M-?T?-|--M-M---M----MB-?-|--------B-|----------B-------?---------T-M-------B----B--T------T?----TM|---B?M--T-T---|---?-----?M-B-T?--?-B--M---T-----f
m-E-E-------E-E-E--E|E------E-EET|--E------T--|-------E|E-|---T-E---EEE-----E|--E--E---E|----E---------------E---T---|-----E-----E----E|---E--|E----|E|EEE--EE-|-|EE-|-EEE--E-EEE---|--E---EE---E|EE-EEX
XXXXXXXXXXXXXXXXXXXXXXXXXXXXXXXXXXXXXXXXXXXXXXXXXXXXXXXXXXXXXXXXXXXXXXXXXXXXXXXXXXXXXXXXXXXXXXXXXXXXXXXXXXXXXXXXXXXXXXXXXXXXXXXXXXXXXXXXXXXXXXXXXXXXXXXXXXXXXXXXXXXXXXXXXXXXXXXXXXXXXXXXXXXXXXXXXXXXXXXX
