--------------------------------------------------------------------------------------------------------------------------------------------------------------------------------------------------------
--------------------------------------------------------------------------------------------------------------------------------------------------------------------------------------------------------
--------------------------------------------------------------------------------------------------------------------------------------------------------------------------------------------------------
--------------------------------------------------------------------------------------------------------------------------------------------------------------------------------------------------------
--------------------------------------------------------------------------------------------------------------------------------------------------------------------------------------------------------
--------------------------------------------------------------------------------------------------------------------------------------------------------------------------------------------------------
--------------------------------------------------------------------------------------------------------------------------------------------------------------------------------------------------------
---------------------------------------------------------------------------------------------------------------------------------------------------------------------------------------------------v----
------------------------------------------------------------------------------------------------------------------------------o-----------------------oo-------------------------------------------f----
--------------------------------------------------------------------o--------------------------------------------------------------------o-------------------------------------o-------------------f----
--?----------------M---------------o------------------------o------------o----------------------------------o-------M---------------------------------------o---o-------------------------------?--f----
---------------------------------------------------------------------------------------------------------------------------------------o---B---------------------------------------------B---------f----
--------------------------------------------------------------------------------------------------------------------------------------------------------------------------------TTo----------------f----
-------M----------------------------------------------------------------------TT----------TT--------------------------TT------------------------TT-----------M------------------||-----------------f----
m-----------E----------------------E------------------------------------------||------E---||----------------E------E--||-------------E------E---||-----------E-----E------------||-----E-------E---X----
XXXXXXXXXXXXXXXXXXXXXXXXXXXXXXXXXXXXXXXXXXXXXXXXXXXXXXXXXXXXXXXXXXXXXXXXXXXXXXXXXXXXXXXXXXXXXXXXXXXXXXXXXXXXXXXXXXXXXXXXXXXXXXXXXXXXXXXXXXXXXXXXXXXXXXXXXXXXXXXXXXXXXXXXXXXXXXXXXXXXXXXXXXXXXXXXXXXXXXXX
