--------------------------------------------------------------------------------------------------------------------------------------------------------------------------------------------------------
--------------------------------------------------------------------------------------------------------------------------------------------------------------------------------------------------------
--------------------------------------------------------------------------------------------------------------------------------------------------------------------------------------------------------
--------------------------------------------------------------------------------------------------------------------------------------------------------------------------------------------------------
--------------------------------------------------------------------------------------------------------------------------------------------------------------------------------------------------------
--------------------------------------------------------------------------------------------------------------------------------------------------------------------------------------------------------
--------------------------------------------------------------------------------------------------------------------------------------------------------------------------------------------------------
---------------------------------------------------------------------------------------------------------------------------------------------------------------------------------------------------v----
----------------------------------------------o--------------------------------------------------------------------------o--------------------------------------------------------------------o----f----
-----------------------------------------------------------------------------------------------------------------------------------------------o-----------o---------------------------------------f----
---------------------------------------------------o--------------------------------------------------M-------------M------o--------------------------------------------?--------------------------f----
--------------------------------------------------------M-----------------------------------------------------o-------------------------------------------M---------o----------------------------B-f----
------------------------------------------------------------------o-o---------------------------------------------------------------------------------------------------------------o------?-------f----
------------------------------TT-----------------------------------?-----------------------------?-------------------------------------------------------------------------------------------------f----
m----------E---E--------------||---------------------------------------------------------E-------------------------------------------------------------------------E-------------------------------X----
XXXXXXXXXXXXXXXXXXXXXXXXXXXXXXXXXXXXXXXXXXXXXXXXXXXXXXXXXXXXXXXXXXXXXXXXXXXXXXXXXXXXXXXXXXXXXXXXXXXXXXXXXXXXXXXXXXXXXXXXXXXXXXXXXXXXXXXXXXXXXXXXXXXXXXXXXXXXXXXXXXXXXXXXXXXXXXXXXXXXXXXXXXXXXXXXXXXXXXXX
