EoXoXooM|---?---------o|T----|----|-----|--------------------B-------E?B------------XE----------B-----|-|MT||---------?---MX?|?-------Bo|-----o---|---------|-E?||------------------B|M-----?XXBEBXXX?EB
X?MoETEM|---o---------TEooXT---------------------------------o-------BMM------------B-----------T-------B?o||-------------E-T?E-------EM------X----------M---?BoB|X-----------------?|------TEEX?EooooT-
o-XX-oBBM-------------ToEMEM-----------------------------------------oE?------------|E----------M-------MEoXM---------E---?-|?o-------|?----|-o----------M---o?EMT?-----------------?o|-----ME-BEMMM|MoB
?BT?|-EMT---B---------o??|XT---------------------------------B-------|TX------------EB----------?-------X||XE---------M---|o|oM-------EM----o-M----------o---E?--EM-----------------EET-----ETME|M||XooM
oMXX?BXX?---B---------XEX?|E-----------------------------------------?BM------------E?------------------ET|?M---------?---XXEEo-------o-----B-|----------T---|TE|-M-----------------|o|-----M?XB?-?|BX|o
XB?oM--|M---o---------MX-E?M---------------------------------E-------oB|------------MB----------T-------MMEMX---------?----|TEo-------T-----?-|--------------XEEoo|-----------------|oM-----TEoEB-oTT??B
?TXoBBXoM---X---------XM?B|X---------------------------------?-------XBE------------TB----------o-------MXXBM---------|---|?-EM-------|-----o-M----------T---ETMBEB-----------------TT|------o?B?MX-?o?o
BT-EB|BME---E----------??-o?---------------------------------M-------?BT------------E?----------?-------?EM?----------M---??E|M-------oE------X----------T---METTTo-----------------|?------T|M-EX|?oBEv
XT?oBX-XX---E---------?-T?B|---------------------------------T-------MT|------------TT----------o-------BXTBX---------|---TEEMX-------EX------o----------o---|TE|B?-----------------|oT-----oB?E|XXB?TB|
--EMTTTET---B---------TXTXEX---------------------------------B-------XM|------------XX----------T-------TM-XE---------?---MMoo|--------?----X-o----------?---E?ooEM-----------------|oB-----T-?BMXEMo-BB
TB?EBTXTM---|-----------MoXE---------------------------------E-------|Xo------------Xo----------|-------M?ETX---------X---?M||E-------MB------M----------X---MT?BT?-----------------EEB------?E|oMTTToXX
BT-ooBo-M---T---------Xo??T|---------------------------------B-------M|-------------?X----------|-------X-||?---------X---T-?T|-------TX----B-X----------X---MTT|-|-----------------EXX-----MXT|B-EM|?oX
E--MTMoME---E---------TBM--E---------------------------------o-------BXo------------?M----------B-------EMX|M---------M---M|||T-------|M----E-E----------E---|o??B------------------EMB-----E?|MMooT|X|?
M?E?-T-EB---E---------??||XX---------------------------------|-------oMX------------BX----------?-------??|Eo---------?----|T|X-------TM------M----------T---BBMB|B-----------------?XB-----?o-EEXoBM?E|
mMT-X?X|X---o----------MToT|---------------------------------M--------X|------------To----------M-------TTT|E---------E---M|MME-------X|----|-?----------T----E|-Xo-----------------|?E-----MEXE|||EB-To
XXXXXXXXXXXXXXXXXXXXXXXXXXXXXXXXXXXXXXXXXXXXXXXXXXXXXXXXXXXXXXXXXXXXXXXXXXXXXXXXXXXXXXXXXXXXXXXXXXXXXXXXXXXXXXXXXXXXXXXXXXXXXXXXXXXXXXXXXXXXXXXXXXXXXXXXXXXXXXXXXXXXXXXXXXXXXXXXXXXXXXXXXXXXXXXXXXXXXXXX
