--------------------------------------------------------------------------------------------------------------------------------------------------------------------------------------------------------
--------------------------------------------------------------------------------------------------------------------------------------------------------------------------------------------------------
--------------------------------------------------------------------------------------------------------------------------------------------------------------------------------------------------------
--------------------------------------------------------------------------------------------------------------------------------------------------------------------------------------------------------
--------------------------------------------------------------------------------------------------------------------------------------------------------------------------------------------------------
--------------------------------------------------------------------------------------------------------------------------------------------------------------------------------------------------------
--------------------------------------------------------------------------------------------------------------------------------------------------------------------------------------------------------
--------------------------------------------------------------------------------------------------------------------------------------------------------------------------------------------------------
----------o--o-----o-----o-o----------o-----oo-o-------------------ooo----oo---o--oo------o---------------------o------------o--o---o-----o--------------o--o-o----------------oo--o----o---------------
-------?o------o--o----M?---Booo---o------?-o--o--M---o---------?---------?---?--------B----B-----------o-BM-oM?-o-Bo?---?-B----M-?B-oo------o------------Bo-B--oo------M?-------?-----------o----------
-----------B----o-----oo-----M-B--B------B----M---------B--oo------?--------?---oBo---------o---o-------oo----------------oM-----o--?o-------------?--------o-o-o--oo----?----o----MB--B----?-----------
---------o-B---ooB-o---B?-T---o-oT------M-B--o-----o-T-------Bo-----------------------M-o--o--o-----o-oo-------------M---oo--?-o----To----o-----?B----o-------oo--o----o--o--T?--oT-------?--T-B--------
-------o--o---o----M--M---|--o---|o?B-----?----o---T-|?-o------o----T-oM-----------o--T-?--?---o---------T--o--T------o------oo-?--o|--T----M---?M----v---B-------o-B---o----|o-oo|-----B---o|M-o-------
-------------------?------|------|--------------B?M|-|---?M-T-T-----|--------------T--|-----------------M|-----|----------?---------|--|--------------fT--B-------------M----|----|----------|----------
m---E---------------E---E-|----E-|-----------E---E-|-|------|-|-----|E-------------|--|----E-------------|---E-|--------E-----------|--|--------------f|--E---------E--E-----|----|----------|----------
XXXXXXXXXXXXXXXXXXXXXXXXXXXXXXXXXXXXXXXXXXXXXXXXXXXXXXXXXXXXXXXXXXXXXXXXXXXXXXXXXXXXXXXXXXXXXXXXXXXXXXXXXXXXXXXXXXXXXXXXXXXXXXXXXXXXXXXXXXXXXXXXXXXXXXXXXXXXXXXXXXXXXXXXXXXXXXXXXXXXXXXXXXXXXXXXXXXXXXXX
