--------------------------------------------------------------------------------------------------------------------------------------------------------------------------------------------------------
--------------------------------------------------------------------------------------------------------------------------------------------------------------------------------------------------------
--------------------------------------------------------------------------------------------------------------------------------------------------------------------------------------------------------
--------------------------------------------------------------------------------------------------------------------------------------------------------------------------------------------------------
--------------------------------------------------------------------------------------------------------------------------------------------------------------------------------------------------------
--------------------------------------------------------------------------------------------------------------------------------------------------------------------------------------------------------
--------------------------------------------------------------------------------------------------------------------------------------------------------------------------------------------------------
----------------------------------------------------------------------------------------------------------------------------------------------------------------------------------------------v---------
-----------------o---oo---o------------o--o--o--o------o---------oo-----o----oo-----o-o-------o--o----------------------------o------------------------o-o--------------o---------------------f--o------
-------?-o---?--------------o?------?--o----?----o--B-----?---o-o---?-?---oo-------?B-----ooo------B----------?M-oo-?--?--o-?--------B---------o--------B--o----o----M----o-B----o----B---?---f-o-------
---------------------oB----ooB-o--------o-?---o-ooo------------MBoo------M---o-o--o--o---oo----o-----------oo--------o----------M-------o-------M-B----Bo---M-o-M-------o?----M---o--B-------of---------
--------------BB----T-o-MB----?-o----To--oo-M-o------T----------------ooo-----B----------B-o-o-?o------oo-?-B--------oo-------?----o--o------B-T------------oT--M--o--ooo--Bo---o---o-o----B--f---------
--------B---M-B---oo|--o-o------M--o-|-----M--M---oo-|-oo--------o--M----T--------o--T-o-----------?-o-o-?oo--------o----o--o-o-?--B-o-----?o--|--oT---o-----|-T-----?---oo-T--B---o--------o-f---------
--------B-----------|--M----T--------|----?--M-------T-----T---------B---|---M------M|-------T--?--B------------------------?------------------|---|----B----|-|-----?------|---------?----M--f---------
m---------E---------|-------|------EE|-----------E---|-----|-------------|-------E---|-E-----|-------------E--------------------E--------------|---|--------E|-|--EE--------|E------------E---XE--------
XXXXXXXXXXXXXXXXXXXXXXXXXXXXXXXXXXXXXXXXXXXXXXXXXXXXXXXXXXXXXXXXXXXXXXXXXXXXXXXXXXXXXXXXXXXXXXXXXXXXXXXXXXXXXXXXXXXXXXXXXXXXXXXXXXXXXXXXXXXXXXXXXXXXXXXXXXXXXXXXXXXXXXXXXXXXXXXXXXXXXXXXXXXXXXXXXXXXXXXX
