--------------------------------------------------------------------------------------------------------------------------------------------------------------------------------------------------------
--------------------------------------------------------------------------------------------------------------------------------------------------------------------------------------------------------
--------------------------------------------------------------------------------------------------------------------------------------------------------------------------------------------------------
--------------------------------------------------------------------------------------------------------------------------------------------------------------------------------------------------------
--------------------------------------------------------------------------------------------------------------------------------------------------------------------------------------------------------
--------------------------------------------------------------------------------------------------------------------------------------------------------------------------------------------------------
--------------------------------------------------------------------------------------------------------------------------------------------------------------------------------------------------------
-------------------------------------------------------------------------------------------------------------------------------------------------------------------------------------------------------v
-------oo------------oo--------------------oo-oo-------o--o-o-----------------o---------o-----o-------------o------o--o-----o--o-----------o------------------o-------o----o---------o-------o---------f
------?--?Bo--MMB--------o--B-------Mo----o-?---B------??-B---B----o-----?--oo-?----?--o------?--M---M-o?--?---oo-oo?o--B--B------?--Mo--M---B-----o-?o-----oo?--o-?--M---o--Boo??------oB?---M-oB-----f
------MM--o-oB-M-o-o----o-?---M-o--o-?oM----M--B-----M-M---B-o-----BM----B----o-B--M-Bo---oo------?---o----B-oM?--M------o-B------o-o-?Mo-----B-------------oM----o------B------o---BoBo-o-ooooo-------f
-------B--B-Too--To-o--BoBT----?-------M-?-----Mo---M--B-Mo-o----B-o--Bo--o-o?---o----B----o-BTB--T--?-o----M---M---o-----o---B-o--?--oo------oMToo----BM---oT------B-ooT----------M-------o-MBTM------f
-------?-o-?|--oo|--?--BoB|---o--Bo?--o-----------M------o?B--o---B-M--oo-oT-?---o------------|---|--?---------oo---TT?-----o----oo--oM-TB-o-oBM|B---?T-oM---|--B------o|---oo--B----o----oM-o-|-------f
------------|--B-|M--?-B--|?MM--B--------------T-------M----M---------B----|--BM?--T-------?B?|--M|----------------B||----T--?--B-------|-----B-|-----|---M--|----------|M?-?-----------B--BM-B|-------f
m---EE--E---|-E--|--E-----|---E-----------E--E-|-E--EE---------------------|-------|E---------|---|----E-E------E--E||----|---E------E--|-----E-|----E|----EE|----E-E---|EE---EE--E--E----E-E--|-E--E--X
XXXXXXXXXXXXXXXXXXXXXXXXXXXXXXXXXXXXXXXXXXXXXXXXXXXXXXXXXXXXXXXXXXXXXXXXXXXXXXXXXXXXXXXXXXXXXXXXXXXXXXXXXXXXXXXXXXXXXXXXXXXXXXXXXXXXXXXXXXXXXXXXXXXXXXXXXXXXXXXXXXXXXXXXXXXXXXXXXXXXXXXXXXXXXXXXXXXXXXXX
