--------------------------------------------------------------------------------------------------------------------------------------------------------------------------------------------------------
--------------------------------------------------------------------------------------------------------------------------------------------------------------------------------------------------------
--------------------------------------------------------------------------------------------------------------------------------------------------------------------------------------------------------
--------------------------------------------------------------------------------------------------------------------------------------------------------------------------------------------------------
--------------------------------------------------------------------------------------------------------------------------------------------------------------------------------------------------------
--------------------------------------------------------------------------------------------------------------------------------------------------------------------------------------------------------
--------------------------------------------------------------------------------------------------------------------------------------------------------------------------------------------------------
---------------------------------------------------------------------------------------------------------------------------------------------------------------------------------------------------v----
-------------o---------------------------------------------------o---------------------------------------------------------------------------------------------------------------------------------f----
-------------------------------------o---------------------o-------------------------------------------------o-------------------------------------------------------------------------------------f----
-----------o---o------------------------------------------------------------------------------o----B-----------------------------M---------------------M----------M---------------------M----------f----
--------------------------------------------------------------------------------------------------------------------------------------o------------------------------------------------------TT----f----
--o-------------------------------------------?-----o----------------------------TT-----------?---------------o---------B--------------------------------------------------------?-----------||----f----
-----------------------------------------------------------B---------------------||------B---------------------------------------------------------------------------------------------------||----f----
m--------------------E------------------------E----------------------------------||--------------------------E----------------------------------------------------------E--------------------||----X----
XXXXXXXXXXXXXXXXXXXXXXXXXXXXXXXXXXXXXXXXXXXXXXXXXXXXXXXXXXXXXXXXXXXXXXXXXXXXXXXXXXXXXXXXXXXXXXXXXXXXXXXXXXXXXXXXXXXXXXXXXXXXXXXXXXXXXXXXXXXXXXXXXXXXXXXXXXXXXXXXXXXXXXXXXXXXXXXXXXXXXXXXXXXXXXXXXXXXXXXX
