--------------------------------------------------------------------------------------------------------------------------------------------------------------------------------------------------------
--------------------------------------------------------------------------------------------------------------------------------------------------------------------------------------------------------
--------------------------------------------------------------------------------------------------------------------------------------------------------------------------------------------------------
--------------------------------------------------------------------------------------------------------------------------------------------------------------------------------------------------------
--------------------------------------------------------------------------------------------------------------------------------------------------------------------------------------------------------
--------------------------------------------------------------------------------------------------------------------------------------------------------------------------------------------------------
--------------------------------------------------------------------------------------------------------------------------------------------------------------------------------------------------------
--------------------------------------------------------------------------------------------------------------------------------------------------------------------------------------------------------
-------o----o---o------o--------o-----------------------o---o---------------oo--o----------------------o---o--o-----o---------o---o---ooo--o----o---o-o-----------------o-o-----------o---------o-------
---------B-oM-M-----?B-o-?------o----------?--ooo-o-o--ooB------MBooB--o---B-o-------------o----o-----oB----B----o----?o---------o-----?--o-B--o----o--B--------o-B-Bo---oo-o-?--------?o----oo---------
-------M------oo-o-----------B--o----B-M--M------------B--?oB---o----M--o--M-?---o-----------?----------Mo?----o------M---?-Mo--------B-M--?-----B-----o?-oM----------o--------oo-M--o-----oM----B------
-------------o--o---T--------o--?--------------oB--Moo------T--M----o---To----------?-?-------o--BoB---M------o----o----------------?-----B--oo----o----o----o-M------------oM-B--o---T--o----T-?-------
-----------M---o-?o-|--oM?--oo------To-Mo-o---o---?------M-o|--T-o-?----|-------oo--T------Mo-o--M-o-------------o----o-------oT----o-M----o-o--M-----v----o--o---o-----M-----o----T-M|-?M----|---------
----------?---------|---------------|--?----B----------B---M|--|-------B|---------MB|-----------B------?---T---M?--M-----B-----|---------B------------fM--?---M?----M-T---------M--|B-|-------|---------
m-------------------|-----------E---|-------E---------------|--|--------|-----------|-----------------E----|-----------------E-|-------------------E--f-------E-E-----|------------|--|-------|-E--E----
XXXXXXXXXXXXXXXXXXXXXXXXXXXXXXXXXXXXXXXXXXXXXXXXXXXXXXXXXXXXXXXXXXXXXXXXXXXXXXXXXXXXXXXXXXXXXXXXXXXXXXXXXXXXXXXXXXXXXXXXXXXXXXXXXXXXXXXXXXXXXXXXXXXXXXXXXXXXXXXXXXXXXXXXXXXXXXXXXXXXXXXXXXXXXXXXXXXXXXXX
