--------------------------------------------------------------------------------------------------------------------------------------------------------------------------------------------------------
--------------------------------------------------------------------------------------------------------------------------------------------------------------------------------------------------------
--------------------------------------------------------------------------------------------------------------------------------------------------------------------------------------------------------
--------------------------------------------------------------------------------------------------------------------------------------------------------------------------------------------------------
--------------------------------------------------------------------------------------------------------------------------------------------------------------------------------------------------------
--------------------------------------------------------------------------------------------------------------------------------------------------------------------------------------------------------
--------------------------------------------------------------------------------------------------------------------------------------------------------------------------------------------------------
-------------------------------------------------------------------------------------------------------------------------------------------------------------------------------------------------------v
------o--------------------o--o--o----o--o----o---o-oooo--------o---o-----o---------------------------o-oo---------------o-------o------o--o--------o-------------o-----------o-o----------------------f
----------Bo----o--MMo---M---?---M-M----B---oB-o?-------?-o-----Bo?o------?-o-o-----------B--B---?--?-o----o-M--BBo-o-------o-?-------?---------B---oM---o---B--M-----??----M-------------------oB-----f
------B-oM--B--oB------o-----Boo--o-----o-----o?--B----M-M---Bo-?--Mo----o?-----o---------oooo-------------------------o--M--o---------o--M--?----B-----o?o----BM----------M-----?----M--------?-------f
---------------M--M-o------B------?--ooB---M------TT------o--o-oo-------o--o-oMMTTT----------o---o-o----?----o-----?---M-M-M--??B-B-o--o----Moo-o-Bo------o--?oo----ooo----o---------B-----TT----------f
-------B?o--oo---o---TT--------?---o--oTT-o--o--M-||--------------------B----M?-|||----o---o--Mo-B--M-MTT-?---------o?-----------o-o----M?--M------o---?----?-------o-----oo--------------M||o---?-----f
--------BM-M------TT-||----------------TT---------||-----------B------B---------|||---------?B-TT------||--------?--B---M--------B-------M--B----------------B-----M------------M--TT---?--||----T-----f
mEEE-E---EE----EE-||E||-E-EE-E--E--E-E-||--------E||---E-----E--E----E-----E--E-|||--EEEE----E-||-E-EE-||-----EE---E------E-------------E------------------------------------E-----||------||-EE-|-E-E-X
XXXXXXXXXXXXXXXXXXXXXXXXXXXXXXXXXXXXXXXXXXXXXXXXXXXXXXXXXXXXXXXXXXXXXXXXXXXXXXXXXXXXXXXXXXXXXXXXXXXXXXXXXXXXXXXXXXXXXXXXXXXXXXXXXXXXXXXXXXXXXXXXXXXXXXXXXXXXXXXXXXXXXXXXXXXXXXXXXXXXXXXXXXXXXXXXXXXXXXXX
