--------------------------------------------------------------------------------------------------------------------------------------------------------------------------------------------------------
--------------------------------------------------------------------------------------------------------------------------------------------------------------------------------------------------------
--------------------------------------------------------------------------------------------------------------------------------------------------------------------------------------------------------
--------------------------------------------------------------------------------------------------------------------------------------------------------------------------------------------------------
--------------------------------------------------------------------------------------------------------------------------------------------------------------------------------------------------------
--------------------------------------------------------------------------------------------------------------------------------------------------------------------------------------------------------
--------------------------------------------------------------------------------------------------------------------------------------------------------------------------------------------------------
----------------------------------------------------------------------------------------------------------------------------------------------------------------------------------------------v---------
-------oo--------------------------------------o---o-o----o-------------------o--------------o------o----o--------------o---------------o-------oo-----o----------o---------------------------f---------
-------?---o-Bo------o?o----M-o---?M--M-----B-----------?o------?-----B-----o-B-o-o----o----M--o-?-------?--M-?-------------o-Bo--------o-------o-------ooB--o--------o-?--------------o--o?--f-oo------
-------B---o--o-----o-----o-----ooo-----------Mo-?o----M-------M-------------oo-o--------?--B-o--?--?o--?M-----------?---o---o----M-----M---------?-------B-----B---o------?MM---------------?fo-o------
-------o-oo----o---M-------B---?------------oBoo------o---M?----o-T------o-?----o--oT------o--?----o------o--T--o--?----------oBo---o------T--o-o----------------T-o----o--------o----?-------fo--------
--------M--o-o-BMB---?--M--T-B-----------------------o---o---B?---|-----T-----M-----|M--o----------T--------M|---T-o--------M-M--------M-T-|-B-o-----oo---B--M---|-?---------o-oo-B------BM---f-o-------
---------------------------|----------MB----------T-------------?-|-----|-----------|----------T---|---------|---|--MT--M----M-?---T-----|-|--M------------------|-------B----M---MM----------f---------
m---E--E-------E-----E-----|-----------E----------|-----E---E-E---|-----|-----------|E-E-E-----|---|-------E-|---|---|-------------|-----|-|-E-E-------E---------|------E------E--------------X-E-E-----
XXXXXXXXXXXXXXXXXXXXXXXXXXXXXXXXXXXXXXXXXXXXXXXXXXXXXXXXXXXXXXXXXXXXXXXXXXXXXXXXXXXXXXXXXXXXXXXXXXXXXXXXXXXXXXXXXXXXXXXXXXXXXXXXXXXXXXXXXXXXXXXXXXXXXXXXXXXXXXXXXXXXXXXXXXXXXXXXXXXXXXXXXXXXXXXXXXXXXXXX
