--------------------------------------------------------------------------------------------------------------------------------------------------------------------------------------------------------
--------------------------------------------------------------------------------------------------------------------------------------------------------------------------------------------------------
--------------------------------------------------------------------------------------------------------------------------------------------------------------------------------------------------------
--------------------------------------------------------------------------------------------------------------------------------------------------------------------------------------------------------
--------------------------------------------------------------------------------------------------------------------------------------------------------------------------------------------------------
--------------------------------------------------------------------------------------------------------------------------------------------------------------------------------------------------------
--------------------------------------------------------------------------------------------------------------------------------------------------------------------------------------------------------
-------------------------------------------------------------------------------------------------------------------------------------------------------------------------------------------------------v
-------------------------o-o--------------------------oo----o-------o------oo---oo--------------------oo---oo---------o------------o------------o-------o--o----o-o---o-----o--------------------------f
-------o-B-----B------?-B----o--------o??-------M-o---?--B---Bo---?-----?-?-o-o----?M-o--?-o----o--B---o-B-o-----B--??B-----oo------?ooo---?----------?------oBo-BB-o-o--?o?-Moo--------M?-B-o---M-----f
--------?--o-Mo--M--o------------o-o--o---M---------oMo-M----oo----ooo----ooo--o-------B---o-oo--o---------o----Boo--o-----o---------o-----?------ooo----M-------o-----?-----B----------o--o--B-oM-----f
-------o--------------------Mo---T-----T--T------o--M---T---------o?o-------T--------o-TBo--To--?---ooo--o-o--o----B----------oT-----o------?M--MM---B-------B---M----o--M-------o--o--T-------o-------f
---------o-Bo-?------B-T---------|-B-B-|?M|----------o-o|-------------------|-------?--|M---|MM--B-o----M-o------?o--M-o-o----o|---o----o-----To-o---o---------ooM----oo---------?Bo---|----o----------f
-------------B---------|--------T|-----|--|-------B--?--|----T--------------|-?--------|T--B|----------M-M----------------B----|--------------|-----------------------?------B---?-----|---------------f
m----EE-EEE-EE-EE-EE---|-E--E---||E--E-|E-|-E---E-------|-E--|--------E-----|------E--E||-E-|--------------E------------E-E--E-|E-E-----EE----|---E---E--------E-----EEE----EE---------|--E--E--EE-----X
XXXXXXXXXXXXXXXXXXXXXXXXXXXXXXXXXXXXXXXXXXXXXXXXXXXXXXXXXXXXXXXXXXXXXXXXXXXXXXXXXXXXXXXXXXXXXXXXXXXXXXXXXXXXXXXXXXXXXXXXXXXXXXXXXXXXXXXXXXXXXXXXXXXXXXXXXXXXXXXXXXXXXXXXXXXXXXXXXXXXXXXXXXXXXXXXXXXXXXXX
