--------------------------------------------------------------------------------------------------------------------------------------------------------------------------------------------------------
--------------------------------------------------------------------------------------------------------------------------------------------------------------------------------------------------------
--------------------------------------------------------------------------------------------------------------------------------------------------------------------------------------------------------
--------------------------------------------------------------------------------------------------------------------------------------------------------------------------------------------------------
--------------------------------------------------------------------------------------------------------------------------------------------------------------------------------------------------------
--------------------------------------------------------------------------------------------------------------------------------------------------------------------------------------------------------
--------------------------------------------------------------------------------------------------------------------------------------------------------------------------------------------------------
-------------------------------------------------------------------------------------------------------------------------------------------------------------------------------------------------------v
-------o--o---------------------o----oo--------------o-----o-o---o------------------------o--o---------o---------o-ooo--oo-------------o-------o------o---------------o------------o-------------------f
--------B------B----o---?--B--------B--------B---o-----?-oo-----------B-o---B---------?-o--oB---M-oo-----?---M--------Bo---B--------B-----------Mo-B-------M---o--B-?---------o?--o------?o--oo--------f
----------oo--o--M-----------oo---?B---o----------------oMB---?--------o---oB--------M-----o--------?---o-----?------oo------o-----------B-M-B--o--------B------------ooo---o----M--o---------Mo-------f
--------BM--o---------------?-------o-----B---B----o---B-----oB--M-?-M---o---o---?---------o-B-o--o--B-----o-----??--M---Bo------M----T------?oo--o--Mo-o-----------oooo--o-----oo--------?o-?-o-------f
-----------B--?-------o---B-oo--------Bo----o--o--------------------o------------o--M-------B----M-----T---o-o--o--M----------B----o--|-----?---oo--------------T-o--o--oooB-----T-----o-o---o-B-------f
-------?-----B----------------------------------------B--M----------------B------B-------B------?------|---------B-----B------?T--M---|-----?----------T-B---?--|B--------------B|M-B------------------f
m-------EE--EEEEE--E---E------E--E--------E--E------------E------E-----------E-----EE---E-------E------|-----E-EEE----E----E---|----E-|E------------E--|-E------|E-E-EEE--E----EE|--E---EE--EE----E----X
XXXXXXXXXXXXXXXXXXXXXXXXXXXXXXXXXXXXXXXXXXXXXXXXXXXXXXXXXXXXXXXXXXXXXXXXXXXXXXXXXXXXXXXXXXXXXXXXXXXXXXXXXXXXXXXXXXXXXXXXXXXXXXXXXXXXXXXXXXXXXXXXXXXXXXXXXXXXXXXXXXXXXXXXXXXXXXXXXXXXXXXXXXXXXXXXXXXXXXXX
