--------------------------------------------------------------------------------------------------------------------------------------------------------------------------------------------------------
--------------------------------------------------------------------------------------------------------------------------------------------------------------------------------------------------------
--------------------------------------------------------------------------------------------------------------------------------------------------------------------------------------------------------
--------------------------------------------------------------------------------------------------------------------------------------------------------------------------------------------------------
--------------------------------------------------------------------------------------------------------------------------------------------------------------------------------------------------------
--------------------------------------------------------------------------------------------------------------------------------------------------------------------------------------------------------
--------------------------------------------------------------------------------------------------------------------------------------------------------------------------------------------------------
---------------------------------------------------------------------------------------------------------------------------------------------------------------------------------------------------v----
----------------------------------------------------------------------------o-------------------------------------------------------------------------------------------------------------------o--f----
--------------------------------o----------o----------------------------------------o----------------------------------------o---------------------------------------------------------------------f----
-----M----------------------o------------------------------?----------------------------------------------------?------------M--------------------------------------------------?---------B-------Bf----
------------------------------------------------------------------------------------------------------------------------?----------------------------------------------------------------------o---f----
-----------------------------------------------B-------------------------------------o---------------B----------------------------M----------------------------------------------------------------f----
---------------------------------M-------------------M-----------------------------------------------------------------------------------------------------?---------------------------TT----------f----
m--------------------------------------------------E-------------------------------------------------------------------------------------------------E---------------------------------||-------E--X----
XXXXXXXXXXXXXXXXXXXXXXXXXXXXXXXXXXXXXXXXXXXXXXXXXXXXXXXXXXXXXXXXXXXXXXXXXXXXXXXXXXXXXXXXXXXXXXXXXXXXXXXXXXXXXXXXXXXXXXXXXXXXXXXXXXXXXXXXXXXXXXXXXXXXXXXXXXXXXXXXXXXXXXXXXXXXXXXXXXXXXXXXXXXXXXXXXXXXXXXX
