--------------------------------------------------------------------------------------------------------------------------------------------------------------------------------------------------------
--------------------------------------------------------------------------------------------------------------------------------------------------------------------------------------------------------
--------------------------------------------------------------------------------------------------------------------------------------------------------------------------------------------------------
--------------------------------------------------------------------------------------------------------------------------------------------------------------------------------------------------------
--------------------------------------------------------------------------------------------------------------------------------------------------------------------------------------------------------
--------------------------------------------------------------------------------------------------------------------------------------------------------------------------------------------------------
--------------------------------------------------------------------------------------------------------------------------------------------------------------------------------------------------------
-------------------------------------------------------------------------------------------------------------------------------------------------------------------------------------------------------v
--------------------------------------oo-------------ooo----------------o---------------------------------o-------oo------o-o--------o-o---o---o-----o-------o-----------------------oo------o---------f
-------?oo-?----------oM-B----------B?--ooB------B--B----B---------Boo--B-------------BB-------B----B---Mo-------?--o-o-------------B---o-------oo?-------M---?-----B-----o---o----------?-------------f
-------M---o--------o----?o--oo---?B-------o--------o----?-o--------?-----M------------------?--oo----------B-?-o---------?--------------B--?o--o--?--M-----o---oo-?o----------B---o---------o---o-----f
--------B-----?--?--M-T-----M-B-o---o-T-----MT-Boo--o-----BT--o?-o-----o---ooo--M-----o--o---o?-M--------------o-o----M-----o-------B-T-?------o-----o-M--B-o--T-----o----o----o-T--B-?--B------o------f
---------o?------o---o|-------o--o----|o---o-|-o---oo------|-o-?----------?----T--Bo-------------------------oo--M----o----o?---o--o--|--?-?o----o-oo-?---o--B-|---o----o-?---T-M|M-------T-T---oo-----f
------------B---?-----|-----------T---|M-----|-------------|------------------M|----------------------------------------------?------B|M----?-----------MB-----|------M----?--|--|------B-|-|---?------f
m-----EE-EE-EE---EE-E-|---E---E--E|---|E--E--|-----EE------|----E------EE-E--E-|----------E---------------E---------E----------EE-----|E-E---------------------|-----E-E-----E|-E|E---E---|E|-EE-EE----X
XXXXXXXXXXXXXXXXXXXXXXXXXXXXXXXXXXXXXXXXXXXXXXXXXXXXXXXXXXXXXXXXXXXXXXXXXXXXXXXXXXXXXXXXXXXXXXXXXXXXXXXXXXXXXXXXXXXXXXXXXXXXXXXXXXXXXXXXXXXXXXXXXXXXXXXXXXXXXXXXXXXXXXXXXXXXXXXXXXXXXXXXXXXXXXXXXXXXXXXX
