--------------------------------------------------------------------------------------------------------------------------------------------------------------------------------------------------------
--------------------------------------------------------------------------------------------------------------------------------------------------------------------------------------------------------
--------------------------------------------------------------------------------------------------------------------------------------------------------------------------------------------------------
--------------------------------------------------------------------------------------------------------------------------------------------------------------------------------------------------------
--------------------------------------------------------------------------------------------------------------------------------------------------------------------------------------------------------
--------------------------------------------------------------------------------------------------------------------------------------------------------------------------------------------------------
--------------------------------------------------------------------------------------------------------------------------------------------------------------------------------------------------------
-------------------------------------------------------------------------------------------------------------------------------------------------------------------------------------------------------v
----------oo-------o-----------o--------o-------------------o-------o-------o-o-oo-----oo--o--oo--------------oo-oo----o-----o-----o--------------------------o----oo--------------------o---o--oo-----f
-------o-?--------B--?-o------BB----B-o----MoB-------?---?-------o-?------o-oB--------?--o--MB-------------BMo---B-o--?-M--Mo--M-M--?----?----MMooo-----o-?o---?-B--M---?----M---?---------B----B------f
---------o--o-?--o----?--o--Mo-o-o-------o-------M------------o-o-----o--M-----Moo-?-B?-o-Mo-----ooo-o---o--o-o-o----ooo---o---o---?---o-----------o----o---oo--?-B--B-B--o-------?--o-o--o-M-B--------f
------o---?o----?-?----M-?T-??---?-B-o-----o-?--M---T-B---?-M-o--ooo?B------B---------B-----oBT?------M-B-M-oo-oM---M----T---?-o-BM-----o--To?--Too-----MB-o-ooo-o--T?-?---ooo----T---------oo---------f
------o-oT-BM--B----------|--o--o-o-----ooT?---B-?--|------M--o----T---T-B----oMo-------o--B-M|--------?B---M----o-o-----|o----------------|MM--|------M----o--MT-M-|B--------B---|BBo----o--B-T-?-----f
--------M|----------------|--?-------M----|---?----B|----MM--B-----|---|---T---?--------------|--B---------?M--M--MTM----|B-MM-----M-B-----|B---|---BT-------T--|---|---M-B--B----|------------|-------f
m-----E--|---E-E----E--E--|-------E--E----|-E-------|--------EE--E-|-E-|-E-|-----------EE-----|------EE-E--------E-|E---E|----EEE----EE---E|----|---E|----E-E|--|--E|-------------|-E--E-E-----|---E---X
XXXXXXXXXXXXXXXXXXXXXXXXXXXXXXXXXXXXXXXXXXXXXXXXXXXXXXXXXXXXXXXXXXXXXXXXXXXXXXXXXXXXXXXXXXXXXXXXXXXXXXXXXXXXXXXXXXXXXXXXXXXXXXXXXXXXXXXXXXXXXXXXXXXXXXXXXXXXXXXXXXXXXXXXXXXXXXXXXXXXXXXXXXXXXXXXXXXXXXXX
