--------------------------------------------------------------------------------------------------------------------------------------------------------------------------------------------------------
--------------------------------------------------------------------------------------------------------------------------------------------------------------------------------------------------------
--------------------------------------------------------------------------------------------------------------------------------------------------------------------------------------------------------
--------------------------------------------------------------------------------------------------------------------------------------------------------------------------------------------------------
--------------------------------------------------------------------------------------------------------------------------------------------------------------------------------------------------------
--------------------------------------------------------------------------------------------------------------------------------------------------------------------------------------------------------
--------------------------------------------------------------------------------------------------------------------------------------------------------------------------------------------------------
-------------------------------------------------------------------------------------------------------------------------------------------------------------------------------------------------------v
------oo-----o--o-------o------o--------o---o---------o--o-----o-----------o-o-----o---o------o---o---o-o---------------------o--o----------oo--ooo----oo--o-------oo--o------o-oo----------o----------f
------oo----o-o---o-----o-ooo-o--o-----------ooo--o-------------o----o--------o------o---o--ooo-----o---------o----------o-----o------o-----oo---o------oo------o-------o--oo--o-oo-oooo---o-ooo-------f
--------------o-----oo-----o-oo----o-o---------------o-o-----o----oo--o----o---oo-o-oo------ooo--o-------o-oo------------------------o----------o------o-o--o---------o-----o------------oo------------f
--------------oo-oo--o-o-o---o-o----o------o--o--o-oo----o--------------o----o-o-o---oo-------o-----------o-----o------------o-------------o-o-o------o--o------o--------o--o--oo-o--o-----------------f
------T-T-o--o-T-o--ToT-T-oo---T--oo----oTT-------T-T-o---T----ooT-oT-T--To-o--oTT--T--o--o-o--------------To--------T-o--------T--Too-oT---T-------o---o-------o--To----T-o---o-----------------------f
------|-|-T----|---T|-|-|------|---TT----||----T--|-|-----|------|--|-|-T|--T--T||--|----TT----T-----------|---------|-T--------|-T|----|---|-T-T--------T---T-----|-----|---------T----------T--------f
m-----|E|E|-EE-|--T||E|E|T-----|EE-|T----||--E-|--|-|-----|----TT|E-|-|-||--|--|T|E-|ET--||E---|---T-TTEE-E|---E-TT--|-|--T-----|-||E---|--E|E|-T-----EEE|T--|-T---|-EE--|--E--EE--|EE-E-EEE-E|-EE-----X
XXXXXXXXXXXXXXXXXXXXXXXXXXXXXXXXXXXXXXXXXXXXXXXXXXXXXXXXXXXXXXXX|XXXXXXXXXXXXXXXXXXXXXXXXXXXXXXXXX----XXXXXXXXXXXXXXXXXXXX|XXXXXXXXXXXXXXXXXXX|XXXXXXXXXXXXXXXXXXXXXXXXXXXXXXX---XXXXXXXXXXXXXXXX----XXX
