--------------------------------------------------------------------------------------------------------------------------------------------------------------------------------------------------------
--------------------------------------------------------------------------------------------------------------------------------------------------------------------------------------------------------
--------------------------------------------------------------------------------------------------------------------------------------------------------------------------------------------------------
--------------------------------------------------------------------------------------------------------------------------------------------------------------------------------------------------------
--------------------------------------------------------------------------------------------------------------------------------------------------------------------------------------------------------
--------------------------------------------------------------------------------------------------------------------------------------------------------------------------------------------------------
--------------------------------------------------------------------------------------------------------------------------------------------------------------------------------------------------------
--------------------------------------------------------------------------------------------------------------------------------------------------------------------------------------------------------
-----------o---o-----------------------o-o----------------o--o-o-o----------------------oo--o-ooo---o---------ooo-------------------o-----------------------------o-----o-oo------------o-----o---------
-------?o--MB------?o--B-----oM--Bo--o?----o---o---oB--oM?--o-----------?--M----o--B----o--------?-------?M-------?------o--------B--?--M-------o?-B---o--------B-----?-M------------B---oo--o----------
----------B--o---o------oo--M-o-o------B-----M---o----o----o--o----------B-----o-----B----------?---M---o-----o---o--------------o----B----?-----oo---B-Bo-------------------o-o-Bo?B--------?----------
-------------T-------o--------------------------oooo-o--M----o---------o------oB?oo--M---o-oo--B-Moo---?----?To---oT-----?B---o-------o------o--o--?---------o---------oo---o-o-B-------Mooo-----o------
--------o---o|---o-----TM---B--------Mo------TB---M-------------M-------o-----M---B--o-----o-oo-----v----M---|-----|-----o-----o-?-M---------M------o--o---oT-----o-------M--o--oo-----------?-o--------
-------------|---------|--?-----M-----M--M---|--------B----------M-------MTM------B-----------------f---?----|-----|T--M------M---------T----------M----M---|-------T-B-----------------?M--------------
m-----E---E--|--------E|---------------------|------------E-----E-E----E--|E------------------------f--------|E----||-------------------|-------E---------E-|-------|--------------E------E-----E-------
XXXXXXXXXXXXXXXXXXXXXXXXXXXXXXXXXXXXXXXXXXXXXXXXXXXXXXXXXXXXXXXXXXXXXXXXXXXXXXXXXXXXXXXXXXXXXXXXXXXXXXXXXXXXXXXXXXXXXXXXXXXXXXXXXXXXXXXXXXXXXXXXXXXXXXXXXXXXXXXXXXXXXXXXXXXXXXXXXXXXXXXXXXXXXXXXXXXXXXXX
