--------------------------------------------------------------------------------------------------------------------------------------------------------------------------------------------------------
--------------------------------------------------------------------------------------------------------------------------------------------------------------------------------------------------------
--------------------------------------------------------------------------------------------------------------------------------------------------------------------------------------------------------
--------------------------------------------------------------------------------------------------------------------------------------------------------------------------------------------------------
--------------------------------------------------------------------------------------------------------------------------------------------------------------------------------------------------------
--------------------------------------------------------------------------------------------------------------------------------------------------------------------------------------------------------
--------------------------------------------------------------------------------------------------------------------------------------------------------------------------------------------------------
-------------------------------------------------------------------------------------------------------------------------------------------------------------------------------------------------------v
------o-----------o---------------------------------o-----o--------------o--------o----o-o------o-o----oo-------o-o-----o------o----------o----------o--------o----o-o--------o---o--o-------o---------f
--------B-B-----Bo-----B------B------?---B-o-o--o-?o-B-----oM?-o---oo----B?Mo-o---B---------B--Mo-o----o-?--?oo--?---------B------?--M---M---B--B--o-?o-----o-?-M---oB----?----M--?------?----o--------f
-----------oMo-B---B-----oo--M------B---------M--M--o-o------o--o-----M-----o-?-----?--?B--------------M-------oo-B-----?o-B--------o-?M------BB-M-----?o---o----?-B------o--M--?-------o-----B--------f
------------T--------oB----------B--T--------o--?--Mo-----o-o-T--oM--M--------MB-B?-o----o-------B----B---oo---------o---Bo-----o-----o-------o-Too-----M--M-T----------o-----o-To---o?-o---o----------f
----------oo|--B-T------?-B---------|-B-----B--B------M-o-o-B-|---T-----T--?-------?-------oM-?---B---o------o--------T?o-----B-M-o--oM--B-o--BM|-----T-oM---|---------??--M---o|---o?o--o-------------f
------------|----|?------M--?-------|T--M-----M-----T-M-------|---|--B-T|---B------------------------------?-B--------|-B-T--?----------------B-|-----|---M--|-----M-B---M---BB-|------B---B-----T-----f
m--EEE-E-E--|---E|-E---------E---E--||--EE--E---E---|---E--E--|---|----||E----------------E----E-----------------E---E|---|----E----------------|-----|-----E|-----E---E-------E|------E-EE---E--|-----X
XXXXXXXXXXXXXXXXXXXXXXXXXXXXXXXXXXXXXXXXXXXXXXXXXXXXXXXXXXXXXXXXXXXXXXXXXXXXXXXXXXXXXXXXXXXXXXXXXXXXXXXXXXXXXXXXXXXXXXXXXXXXXXXXXXXXXXXXXXXXXXXXXXXXXXXXXXXXXXXXXXXXXXXXXXXXXXXXXXXXXXXXXXXXXXXXXXXXXXXX
