--------------------------------------------------------------------------------------------------------------------------------------------------------------------------------------------------------
--------------------------------------------------------------------------------------------------------------------------------------------------------------------------------------------------------
--------------------------------------------------------------------------------------------------------------------------------------------------------------------------------------------------------
--------------------------------------------------------------------------------------------------------------------------------------------------------------------------------------------------------
--------------------------------------------------------------------------------------------------------------------------------------------------------------------------------------------------------
--------------------------------------------------------------------------------------------------------------------------------------------------------------------------------------------------------
--------------------------------------------------------------------------------------------------------------------------------------------------------------------------------------------------------
--------------------------------------------------------------------------------------------------------------------------------------------------------------------------------------------------------
----------o-ooo-o-o-------oo----------------------------o---o--------o--o-----------o-o---o----o-o---------oo--o--o-------o---o---------------------------------------oo--------------------o-----------
-------?o-o-------?---o--o---ooB--B----o--M-----------o---?--o----B----o-----o----------o--?--------B----M-o----B?-----------?-------o?--?---Mo?---o---B----ooo---o---B---oo------B--M---B-----o-M------
-------B-?M---------o---Mo--o-o--o---oB---o?--?-----M---o--o-o--oM--o-o--o-----------?--o-----oM----Bo----o----------Mo---o-o--B-o--B-------------------?-------oo--------o--o-------------------o------
--------------------?---M--M--o-T---o------o-B-oo--o---?-----T-B?----M------o---?-------------B-oo---T-oo-o----------oB---------------o-B-T----?-----M--o------------o--------T-o-TB--o-o----M----------
v--------?---------o-?oo--------|?----B-----o---oo-o-----M---|o---ooMoo---o----B--?T---------o-o--o--|o----oo------B-o--M-------o?-o?o-o-M|o---T-o---------o----B-----o---T--M|o--|----oT----T---M------
f--------?-?--------------------|----------?-----------------|--?----------T-?-----|-------B--?M-----|------------------TT----------T--M--|----|--BM--------?B--B----?----|---|-B-|--?--|----|----------
f------E------------E---E-------|--E-E--------E------E-----EE|----E--------|----E--|--E--------------|------EE----E-----||---------E|-E-E-|----|--------------------EE--E-|--E|E--|-----|----|----------
fXXXXXXXXXXXXXXXXXXXXXXXXXXXXXXXXXXXXXXXXXXXXXXXXXXXXXXXXXXXXXXXXXXXXXXXXXXXXXXXXXXXXXXXXXXXXXXXXXXXXXXXXXXXXXXXXXXXXXXXXXXXXXXXXXXXXXXXXXXXXXXXXXXXXXXXXXXXXXXXXXXXXXXXXXXXXXXXXXXXXXXXXXXXXXXXXXXXXXXX
