--------------------------------------------------------------------------------------------------------------------------------------------------------------------------------------------------------
--------------------------------------------------------------------------------------------------------------------------------------------------------------------------------------------------------
--------------------------------------------------------------------------------------------------------------------------------------------------------------------------------------------------------
--------------------------------------------------------------------------------------------------------------------------------------------------------------------------------------------------------
--------------------------------------------------------------------------------------------------------------------------------------------------------------------------------------------------------
--------------------------------------------------------------------------------------------------------------------------------------------------------------------------------------------------------
--------------------------------------------------------------------------------------------------------------------------------------------------------------------------------------------------------
--------------------------------------------------------------------------------------------------------------------------------------------------------------------------------------------------------
-------o--------o-o------o-----------------------------------o---o-o-------o---------oo--------o------------------o--o--------o----------o----o-----------o--------o----o------------o------o---o-------
--------?----?------Bo-?--M-------o--B--?-o---------B--o-----o---?--B------o--?-o-o--o----??------------MB--------o-B---o--o-o--oB--?o------o?---oo-----o-Mo---M-?B-Bo---B------?------------?---o------
---------M---------o-B-o--------------M------M---o----o?-?--------------B-o---------------Bo--M-o---------?oo-o-o----o-------------o--o--Moo--B---B-o----o----?------o------------oMB-----Bo-?---o------
------------o---------o---B-------o--oo--------?---ooo--o-To----M-M--o--o-T------?-----M-o-oo-------o------B---oo------oM---M--------Bo------------Bo------------B--M---M-?-----------o--ooM-Moo-o------
----------o--M---o----Bo--o-M?--MM-----o---o-TB---------o-|--o-------o---?|M?o----o-M---------B---o-v?-oo-?----M--ooB-----T---o-o-T-------------B?---------------------o?------M-o---MT-----o-oM--------
-----------------------------?-TT------------|---------?--|--------------T|-----M--------------T----f---------B-----------|--T----|-------------B-----------------------------?-------|-----------------
m----------E--------E------E---||E----EE-----|-E----------|--------------||------------E-------|----f----------E-E--------|--|--E-|--E---E-----------E----------------E-----E---------|--E-E------E-----
XXXXXXXXXXXXXXXXXXXXXXXXXXXXXXXXXXXXXXXXXXXXXXXXXXXXXXXXXXXXXXXXXXXXXXXXXXXXXXXXXXXXXXXXXXXXXXXXXXXXXXXXXXXXXXXXXXXXXXXXXXXXXXXXXXXXXXXXXXXXXXXXXXXXXXXXXXXXXXXXXXXXXXXXXXXXXXXXXXXXXXXXXXXXXXXXXXXXXXXX
