--------------------------------------------------------------------------------------------------------------------------------------------------------------------------------------------------------
--------------------------------------------------------------------------------------------------------------------------------------------------------------------------------------------------------
--------------------------------------------------------------------------------------------------------------------------------------------------------------------------------------------------------
--------------------------------------------------------------------------------------------------------------------------------------------------------------------------------------------------------
--------------------------------------------------------------------------------------------------------------------------------------------------------------------------------------------------------
--------------------------------------------------------------------------------------------------------------------------------------------------------------------------------------------------------
--------------------------------------------------------------------------------------------------------------------------------------------------------------------------------------------------------
--------------------------------------------------------------------------------------------------------------------------------------------------------------------------------------------------------
-------o----o---o--------------o------o-o-----o---------------o-------------------o-o---------o-------------------o----------o-----------------o--o------------o---o----------------o---o-------o-------
---------B-o--M-----?-------o-----?----B-??-M--o-----B---?---M-----------------?-------B--------B----?-o--------?------------oM--B----?----?------oBMB-o--M-oB-----oo?---oo-----?--B-----?o-o-----------
-------M------o---------------o--------o-oo--M---M-o-o-B--o-?--o---------o--M-------o----o-B------?--o---------o------o---o-----------o--M?---o--------o?------------o---M-------o---o--M--------B------
----------------o--------o---------?o-?oM----o--o-o--B-----o-B-o-----------o--M-oo---B-----------------?-----------------o---o------oo--------o-M--------M-o-----oo-------Bo--------------o---T---------
-----------M---B-?--o----?-TMM-oT-----Mo-B--------M-----o----M-----o--------o----o--------T-----M-------o-?oM---------------oT--o-?--------o--o-------v--------M----B---------B---o----oo-o---|---------
----------?----------------|----|--------------------M-----------B------------------?---B-|--T--B--?--?--T-----?--M-----B----|----B--------T----------T-M------------------M---B-----?--------|---------
m--------------------------|----|------------E------E----------------------------------EE-|--|-----------|-------E-----------|----E-------E|----------|----------E---------E----E------EE-----|-E--E----
XXXXXXXXXXXXXXXXXXXXXXXXXXXXXXXXXXXXXXXXXXXXXXXXXXXXXXXXXXXXXXXXXXXXXXXXXXXXXXXXXXXXXXXXXXXXXXXXXXXXXXXXXXXXXXXXXXXXXXXXXXXXXXXXXXXXXXXXXXXXXXXXXXXXXXXXXXXXXXXXXXXXXXXXXXXXXXXXXXXXXXXXXXXXXXXXXXXXXXXX
