--------------------------------------------------------------------------------------------------------------------------------------------------------------------------------------------------------
--------------------------------------------------------------------------------------------------------------------------------------------------------------------------------------------------------
--------------------------------------------------------------------------------------------------------------------------------------------------------------------------------------------------------
--------------------------------------------------------------------------------------------------------------------------------------------------------------------------------------------------------
--------------------------------------------------------------------------------------------------------------------------------------------------------------------------------------------------------
--------------------------------------------------------------------------------------------------------------------------------------------------------------------------------------------------------
--------------------------------------------------------------------------------------------------------------------------------------------------------------------------------------------------------
-------------------------------------------------------------------------------------------------------------------------------------------------------------------------------------------------------v
------o---o--o-o-o---oo--o-o-------------oo--o--o----o---o-o--------o----o------o----oo-------------------------------oo----o--o-o-------------oooo-----o---------------oo-----o-o----oo-o-----o-o-----f
-------o-------o--o--o-----o-o-o-o--------o----o------o---------o------o---------oo-oo--o-o-oo-------oo------------o----------o-o-----o----o--o-------o-----o-----o-oo---oo--------------o--oooo-------f
---------oo----oo----o--o-----ooo-----o--oo---o---oo-------------o-----o----------oooo--o-o---o-o-ooo-----o----o-o----o--------o----o----o------oooo---o-----oo-o-o----o-o-----o-----------o-----------f
--------------o-o-o-----o--o----------------o----------oo--o----o----o------------o-----o----------o-o--o--o------------------o----o-o-o---------------o-o------oo--o-------------oo-----o-o-o---------f
------o-oo-------o---TooT--T----T-T------oo-------o--T--o---o--o---o----o---o----T-oT---o------o---oo---o--T--------o-T--To---------T----o----T-o--o-oTo----T------o-oT---------o---o---To----o--------f
------TT-T---T-------|--|--|TT--|-|----------TT------|---------T-------T---------|--|-----T-----T----------|--T--T--T-|--|----------|---------|-------|---T-|----T----|----------------T|--T-----------f
m-----||-|---T-----E-|-T|E-|||-E|E|E-E-T----T||TT--TE|-E--EEET-|---E--E|-----E--E|--|-----|--T--|ETEEE-TE-T|-E|T-|-E|-|--|--T--E---E|--TT--EE-|EE-TET-|E-E|T|TE-E|-E-T|EE--E------T----||--|-----------X
XXXXXXXXX--XXXXXXXXXXXXXXXXX|XXXXXXXXXXXXXXXX|XXXXXXXXXXXXXXXXXXXXXXXXXXXXXXXXXXXXXXXXXXXXXXXXXXXXXXXXXXXXXXXXXXXXXXXXXXXXXX|XXXXXXXXXXXXXXXXXX---XX|XXXXXXXX|XXXXXXXXXXXXXXXX--XXXXXXXX|XXXXXX----XXXXX
