--------------------------------------------------------------------------------------------------------------------------------------------------------------------------------------------------------
--------------------------------------------------------------------------------------------------------------------------------------------------------------------------------------------------------
--------------------------------------------------------------------------------------------------------------------------------------------------------------------------------------------------------
--------------------------------------------------------------------------------------------------------------------------------------------------------------------------------------------------------
--------------------------------------------------------------------------------------------------------------------------------------------------------------------------------------------------------
--------------------------------------------------------------------------------------------------------------------------------------------------------------------------------------------------------
--------------------------------------------------------------------------------------------------------------------------------------------------------------------------------------------------------
-------------------------------------------------------------------------------------------------------------------------------------------------------------------------------------------------------v
-------------o--o--------------------------o-----o---------------o------oo----o-oo----o--o----------------o--------o-----o-----o-----o-------------------o-o-----o--------o-------o-------o------------f
----------------?B-M---B-o-oo--?-Bo--?M-----?-B--------B--o?---o------o--o-?oo-o-o-----?------?o---M--B--o----o-ooMB--M-M-?---M-ooo-??--o--B--Boo-oMM--B--?-----ooo-------?--------oM---Bo-------------f
--------------oo--------o---o--o--BM?----------o---o------oB-?o---o-B---M---o---M--B-oo----B------o----o-oB-MoB---o-o--o-----o?---B----oBMo------o--o---o-----oo-?---------B-o----------oo----o--------f
----------?-oo--o----oo-B------o-M--T----oM---M---T---M-??oo---M?-?o--oo------o-----Mo---o---Mo-B----o----o---M---------?M---MT--o-?o-Bo-o----B?oo--oM--B-?o----o-----o?-o--T-ooo-M-----?o---o?o-------f
-------?----?o----T---M-----?-B--B-BT-------o---o-T-o----oTM--o---?Boo-T?o-----Moo---T--o------MB--T-o--M--------o-M-M----o---|-------M------ooM--B--B--------------o?--o-M-|--?-B--MoM--?----M?T------f
------B--B--B-----|??--B--B-----M---|---B?----?---|-------|------------|-------------|-----B---M?--|---B--------?------------B|------------B--------T---M------------?---M--|----BT--M---?--T---|------f
m-E-E-E--EE--E----|----E---EEE---E--|-E-E----EE---|EE-----|E----E-E--E-|--------E----|-E----------E|--E-----E---------------EE|--E-E------E-----E---|---EE-E-E--------E-E---|E----|----EE---|E--|-EEE-EX
XXXXXXXXXXXXXXXXXXXXXXXXXXXXXXXXXXXXXXXXXXXXXXXXXXXXXXXXXXXXXXXXXXXXXXXXXXXXXXXXXXXXXXXXXXXXXXXXXXXXXXXXXXXXXXXXXXXXXXXXXXXXXXXXXXXXXXXXXXXXXXXXXXXXXXXXXXXXXXXXXXXXXXXXXXXXXXXXXXXXXXXXXXXXXXXXXXXXXXXX
