--------------------------------------------------------------------------------------------------------------------------------------------------------------------------------------------------------
--------------------------------------------------------------------------------------------------------------------------------------------------------------------------------------------------------
--------------------------------------------------------------------------------------------------------------------------------------------------------------------------------------------------------
--------------------------------------------------------------------------------------------------------------------------------------------------------------------------------------------------------
--------------------------------------------------------------------------------------------------------------------------------------------------------------------------------------------------------
--------------------------------------------------------------------------------------------------------------------------------------------------------------------------------------------------------
--------------------------------------------------------------------------------------------------------------------------------------------------------------------------------------------------------
-------------------------------------------------------------------------------------------------------------------------------------------------------------------------------------------------------v
-------o------------------------o-o-----oo-o-oo--oo-----o-oo---o------o-----o----o-o--------o-o---o---------oo-oo--o----o---------------o--o-ooo-o-------o-----------o----o---o---o---o-----oo-o-o-----f
------?-------o--BM---M--M?o-M-oo-o?--BM-Bo-?o-o-?B----MB--o-B-M----B?-oo-B-o---?-o???-----B---o-oB-M---?M-MoM----o?-?--?-o---o-?--o---?-o?------M-?----B-oM--o-B--M--?oo-Mo??Bo----?BM--Boo----BM-----f
------ooo-oBoo-?-?ooB-----M--B-ooMo-BoB--o-?M--Mooo--o--oM---B-o------o-----BoMM-?-M---?-o-?o----oB?----oBM-Bo---------B---B-M-----Boo---o-----B----------o---o----oMoo---M-o-M-oooo?--B--?--o--B------f
-------oo-----oMT--Mo-T-?oo-o-oMToooo-oM?-BooooM--M-MBB--TM---o-ooT--oo--ooB--ooo-M--o--ooo-Bo-M----T--oo--o--T-oB-M----o---o------?o-o--?--TBo---Too-o-?----o----B---o-oo--M--oooo-----------?-T------f
------o---B--ooT|-----|--ooBo-?o|o--o-B--oooooo-o-oT---M-|o---o---|--oo-oB---ooooB-Too-B--B-M---o--o|-o-?---T-|oBB---M---------o---T-Mo-M---|?-Mo-|--?M?oo-------------oB-oBM---?oM------?-?oo-o|------f
-------------?-||---B-|--B-B--MM|--?---?--MMMMB-M--|-----|--B-----T-----T------M--M|----?--------T-M|--M----|-|---BM---------T-----|M-------|T-M--|------------BT-----TMT-M------B----?---------|M-----f
mEE-EE-E-E-E-EE||E--E-|E------EE|-E--E-E----E------|E--E-|----EE--|--E--|--E-----E-|-E-----------|--|----E--|-|-EE--------E--|-----|--------||----|--------E----|----E|-|------------------E----|------X
XXXXXXXXXXXXXXXXXXXXXXXXXXXXXXXXXXXXXXXXXXXXXXXXXXXXXXXXXXXXXXXXXXXXXXXXXXXXXXXXXXXXXXXXXXXXXXXXXXXXXXXXXXXXXXXXXXXXXXXXXXXXXXXXXXXXXXXXXXXXXXXXXXXXXXXXXXXXXXXXXXXXXXXXXXXXXXXXXXXXXXXXXXXXXXXXXXXXXXXX
