--------------------------------------------------------------------------------------------------------------------------------------------------------------------------------------------------------
--------------------------------------------------------------------------------------------------------------------------------------------------------------------------------------------------------
--------------------------------------------------------------------------------------------------------------------------------------------------------------------------------------------------------
--------------------------------------------------------------------------------------------------------------------------------------------------------------------------------------------------------
--------------------------------------------------------------------------------------------------------------------------------------------------------------------------------------------------------
--------------------------------------------------------------------------------------------------------------------------------------------------------------------------------------------------------
--------------------------------------------------------------------------------------------------------------------------------------------------------------------------------------------------------
----------------------------------------------------------------------------------------------------------------------------------------------------------------------------------------------v---------
---------o----------o------------------o----o----oo----o-o----o-----------------------o-o------o-------------o---o--------------o---------------o------------o-o--o--o-------oo-o-----------o-f-o-------
-------?-----Bo-----?-----BM-o-o-o-----------MB-----B------------M--?o-o----?---oB--Mo------?--M-o----o-B------?-o---B----o--?---------o--?------o--?o-o-----------o-------BBoo-------B---?-M-fo--------
-------B--------------B-oM----o-----o----o-?----------?----?Bo-MBoo-----Mo--oB------o---B---o-o-----?---------M--------M-------o--o---o--o-M----------?-------o-----------o----o--o--B-o------fo-o------
-------o-------------o-----o--oM?--------oB-----o--M----To-?-o-----M-o--------oo---M---------------?---o--o--------T-----M---------o-----B--oT--B-o-o----o-----?-----B-----o---M----o--o----B-f---------
--------M--B-o--MBoB--B------o--o---MM-oo-B---o?----o---|--------o--MT-o-T--M---M-----?---------o-To-------T---Mo-o|------?--------To---o--M-|-------------o---o?-?--oM?--T---M---------?---?of-o-------
-----------------MB--------------M--T------T------M-----|--M---------|---|---------?----M--M------|----B---|---B---|?-----B-------?|---------|----B----------------------M|--B--------T-------f---------
m-----------E------------------E----|---E--|----E-------|------------|---|--------------E--E------|------E-|-------|--------------E|-E---E---|--------------------------E-|-----------|-----E-X-E-------
XXXXXXXXXXXXXXXXXXXXXXXXXXXXXXXXXXXXXXXXXXXXXXXXXXXXXXXXXXXXXXXXXXXXXXXXXXXXXXXXXXXXXXXXXXXXXXXXXXXXXXXXXXXXXXXXXXXXXXXXXXXXXXXXXXXXXXXXXXXXXXXXXXXXXXXXXXXXXXXXXXXXXXXXXXXXXXXXXXXXXXXXXXXXXXXXXXXXXXXX
