--------------------------------------------------------------------------------------------------------------------------------------------------------------------------------------------------------
--------------------------------------------------------------------------------------------------------------------------------------------------------------------------------------------------------
--------------------------------------------------------------------------------------------------------------------------------------------------------------------------------------------------------
--------------------------------------------------------------------------------------------------------------------------------------------------------------------------------------------------------
--------------------------------------------------------------------------------------------------------------------------------------------------------------------------------------------------------
--------------------------------------------------------------------------------------------------------------------------------------------------------------------------------------------------------
--------------------------------------------------------------------------------------------------------------------------------------------------------------------------------------------------------
-------------------------------------------------------------------------------------------------------------------------------------------------------------------------------------------------------v
---------oo-o-o----o------o-ooo-o---------------oo---o--o--------o-------o-o-o---oo-o----o--o--o-----oo----o-o-----o-----o----o---oo----o-oo------------------oo-o-----oo-o--oo---o-----oooo-o--o------f
------?M-B---Boo---B-Bo-oo---oo?--o---o-?o---??------o--Bo-o-Mo-?o-?--ooM--?--?-?-?oMoo?M-o-o-?o--?oo-M?B-Bo-M--o-B-oM-M--oM-MBB-o-----o---Bo?-B--?MooBoo---Boo---MB--o--oM-BM-o--o----?o---oo-MB------f
---------o--?M?-o--B?-----o--------BB---B--B----?--BB----?B-?o--M--?------Bo---Moo-o-----??o-?MBoBoo--o--MBoMooo----o--?---oo-B----B??-o--o---B-?--oo---o-??-?oMo--BB------?--M---?-?-o--------o-o-----f
--------B----M-BooM-o-------?oM?-M-o-?-M-o----o--------oBoooM---M-MM----Mo-Bo--?o?o-M----oM--?-o-?o-M-oB---ooooB-o-o--?MB-------M----M-----o---o--------M-o?-o-o?---o---Bo--MoMM--M?---o----o??o-------f
-------oB-o-Mo-ooo--T-B-o-o--oo--T--o--?o--o-Moo-Mo-oM-o-TMoBooo--o---?--TM-oTo-oBBo---oo?B?oTo----o?oo--?--?o-M-----oToB-oBo------B-o----M-----------T?MooM?M---M-MoTo-Bo---o?-oM-?o?-----M-T-M-T-----f
-------MM--M-B------|--M-M-------|--------------T-----T--|M---?M-B---?---|---|----?M-M-M--MBM|----BT--M--?----T--M--?-|------M---MBM------?TB-TB----TM|---BMM--M-T---|--M?-----?M-B-T?--?-B--|---T-----f
m-E-E-------E-E-E--E|E------E-EET|--E------TT---|-E--E|-E|-E--EE-E--E----|---|E-------E--E---|-----|----EEE--E|E---E--|-E-EE----E----E-E---|--|E----|E|EEE--EETE-|EE-|--EE--E-EEE---|--E---EE|--E|EE-EEX
XXXXXXXXXXXXXXXXXXXXXXXXXXXXXXXXXXXXXXXXXXXXXXXXXXXXXXXXXXXXXXXXXXXXXXXXXXXXXXXXXXXXXXXXXXXXXXXXXXXXXXXXXXXXXXXXXXXXXXXXXXXXXXXXXXXXXXXXXXXXXXXXXXXXXXXXXXXXXXXXXXXXXXXXXXXXXXXXXXXXXXXXXXXXX|XXXXXXXXXX
