--------------------------------------------------------------------------------------------------------------------------------------------------------------------------------------------------------
--------------------------------------------------------------------------------------------------------------------------------------------------------------------------------------------------------
--------------------------------------------------------------------------------------------------------------------------------------------------------------------------------------------------------
--------------------------------------------------------------------------------------------------------------------------------------------------------------------------------------------------------
--------------------------------------------------------------------------------------------------------------------------------------------------------------------------------------------------------
--------------------------------------------------------------------------------------------------------------------------------------------------------------------------------------------------------
--------------------------------------------------------------------------------------------------------------------------------------------------------------------------------------------------------
-------------------------------------------------------------------------------------------------------------------------------------------------------------------------------------------------------v
-------oo---------o----o------o--------o-oo--o--o-----ooo--oo-oo--o-o---o--o-------o---o------o-o--o-o----------------o---------------------------o------o----------o-----o--o--------o----------------f
------?--MB------o-?--o?-o--oBM--?o---o-o---?B--M--M--?--?-----B-oMB-----oB-o---o---B-oMMo----?o------?--M------?-----B------B----oBM---?----o-Boo--o-----?--B?-M---?----?---------oo---MB?---?-oB-----f
----------o--?--BB---M--o-M-?ooo-----o--oB----?----o?--B---o---o-------oB-o-B--o---o-Bo--------M-M--BBBo-----o--o-o--?oM-o-------oBo--o---o--------o--------------o----o?---B--M-M-?----o---oM---------f
----------BM-T---o-----o--o--?B---B---oBo--------M--?---B--M--o----o--o-BM---o-oo--M-o---o--B---?o-----oo---o-o-----??o---M------------o-T------?o---T--oMoTB----o--?To-o-ooo-o---------o-----BM-------f
-------M-B-o-|------Bo----?-----BM--o------B-oM-MoB-o-o--o---o-oTBo-oo--M-------B-------o---o-----ooM-oo-----o---Bo--oo-----o---oT-o--M-B|-o---------|M-Bo-|----M---B|---oo-----o----MTo--MM-o-MTo-----f
-----------T?|-------------M---M---------M-??----?-------M---?--|-B---?--T----TM------B---M----?--M-----------B-------------T--??|---?---|-----T-----|-----|----B?B--|T--M---B--------|---M-----|------f
m--EE-E----|-|E-E--E----E-------EE------E-E--------E-E-E--------|-------E|----|------E-----------E------E-E-----------------|---E|--E----|--E--|--E-E|---E-|-E-------||---E-E--EE-----|--EE-E---|---E--X
XXXXXXXXXXXXXXXXXXXXXXXXXXXXXXXXXXXXXXXXXXXXXXXXXXXXXXXXXXXXXXXXXXXXXXXXXXXXXXXXXXXXXXXXXXXXXXXXXXXXXXXXXXXXXXXXXXXXXXXXXXXXXXXXXXXXXXXXXXXXXXXXXXXXXXXXXXXXXXXXXXXXXXXXXXXXXXXXXXXXXXXXXXXXXXXXXXXXXXXX
