--------------------------------------------------------------------------------------------------------------------------------------------------------------------------------------------------------
--------------------------------------------------------------------------------------------------------------------------------------------------------------------------------------------------------
--------------------------------------------------------------------------------------------------------------------------------------------------------------------------------------------------------
--------------------------------------------------------------------------------------------------------------------------------------------------------------------------------------------------------
--------------------------------------------------------------------------------------------------------------------------------------------------------------------------------------------------------
--------------------------------------------------------------------------------------------------------------------------------------------------------------------------------------------------------
--------------------------------------------------------------------------------------------------------------------------------------------------------------------------------------------------------
-------------------------------------------------------------------------------------------------------------------------------------------------------------------------------------------------------v
------------o------------o---o----o--------------------o---o-----oo-------------------------------o---o---o----o--------------------o--------o--o-----o-o--------o-------------------------------------f
-------o?------------?o-?o----------B--o--------?---------B---------B------------------B---o---B----B------o-----?-B---?--oB-o-----o--oo--?----Bo--?---M--o----o-?-o-o-----?-Moo-M--B--------oB--------f
--------o-o---oB----?-------o-o--------?-----B-----o----?------o--o----M--o--B-------o-M--oo--o-o-----o-?--BB-?-o---?o--B-----o---o-----o--------o--------o---o-------o-----o----M-----------o---------f
--------?-------oo-----T-----o-----o--o--?-oo--o-o-------B--o------?------------M--------o----?-M-------T-------o--o-------T---B--o--B------M---To-----M----B---o?-------M------------Mo?------?M------f
-------o---?-----oM-oo-|--T-----?--?-oo------o--T----o---------T------o-oB-----o--Bo----------Bo--------|---Moo-------T----|-----o---o?B-Mo-----|-------MB------B----To-----Bo-o-----------?--M--------f
-----------------------|--|----?----B--------M--|----?-------T-|--B---B----M--B---------------------BB--|-------------|----|-----?--------M-----|------M-------------|-B---------------M---T-M---------f
m---EEEE-EE--EE--E--E-E|--|------E-------E-E----|-----E------|-|------E--------E------E---E-------------|-E---E-------|----|----------E-E----E--|---------E-------E-E|----E-EE-E-------EE-E|-----------X
XXXXXXXXXXXXXXXXXXXXXXXXXXXXXXXXXXXXXXXXXXXXXXXXXXXXXXXXXXXXXXXXXXXXXXXXXXXXXXXXXXXXXXXXXXXXXXXXXXXXXXXXXXXXXXXXXXXXXXXXXXXXXXXXXXXXXXXXXXXXXXXXXXXXXXXXXXXXXXXXXXXXXXXXXXXXXXXXXXXXXXXXXXXXXXXXXXXXXXXX
