--------------------------------------------------------------------------------------------------------------------------------------------------------------------------------------------------------
--------------------------------------------------------------------------------------------------------------------------------------------------------------------------------------------------------
--------------------------------------------------------------------------------------------------------------------------------------------------------------------------------------------------------
--------------------------------------------------------------------------------------------------------------------------------------------------------------------------------------------------------
--------------------------------------------------------------------------------------------------------------------------------------------------------------------------------------------------------
--------------------------------------------------------------------------------------------------------------------------------------------------------------------------------------------------------
--------------------------------------------------------------------------------------------------------------------------------------------------------------------------------------------------------
-------------------------------------------------------------------------------------------------------------------------------------------------------------------------------------------------------v
-------o-------o-------o--------o-----o-----o---o-o-o--o--------------------o--oo--o-o---------------oo----oo-----o------o-o------o----o----o----------------o-----------------------------------------f
---------B---------?-B----?----o------?oo-----o---?---o-----B--o---o-------B--o---B--BB------o-?MB--o--oo-----o----B-----------?o-M-B-o-------M?o-------o-M---?-----B--------------o-----o-B-----------f
--------?-o-----ooo--------------o---o---o-o-o?-------------------?o--------o----?---B--M---M---?-?--o-----------o-M?M--B---?---------------?---------------o---oo--o------------?------M---o-o--o-----f
-----------?----B-?--------o---o-oo-o-------o--o---?T-----M?--o----o---o---o-------------M-o----M-o-B-----oM---o?B-----oo--T------oo--T-------------o--o--B-o--T----o--B-----------------M-o-T-B?------f
----------------B-----------o--B-----------BB-?Bo-o-|---o--o?-T--o-o---To--o------B-------o---?-----o-TM-B----T--o-oo------|o-B-oooo-T|-----------M------oo--B-|---o------??------B----M-----|oB-------f
----------------------------------?----?------------|-?-B-----|--------|------------T-T---M-----T-----|-------|---B--B-T---|--?------||-MT---------T-----M-----|------------------?--------B-|---------f
m---E-E-E----E----E---E---E-------E-----------------|-----E---|EE----E-|------E-EEEE|-|E----E---|-----|EE-----|---E---E|---|---EE-E--||E-|EE-------|----E-----E|----E--E-----E-E----------E--|---E-----X
XXXXXXXXXXXXXXXXXXXXXXXXXXXXXXXXXXXXXXXXXXXXXXXXXXXXXXXXXXXXXXXXXXXXXXXXXXXXXXXXXXXXXXXXXXXXXXXXXXXXXXXXXXXXXXXXXXXXXXXXXXXXXXXXXXXXXXXXXXXXXXXXXXXXXXXXXXXXXXXXXXXXXXXXXXXXXXXXXXXXXXXXXXXXXXXXXXXXXXXX
