--------------------------------------------------------------------------------------------------------------------------------------------------------------------------------------------------------
--------------------------------------------------------------------------------------------------------------------------------------------------------------------------------------------------------
--------------------------------------------------------------------------------------------------------------------------------------------------------------------------------------------------------
--------------------------------------------------------------------------------------------------------------------------------------------------------------------------------------------------------
--------------------------------------------------------------------------------------------------------------------------------------------------------------------------------------------------------
--------------------------------------------------------------------------------------------------------------------------------------------------------------------------------------------------------
--------------------------------------------------------------------------------------------------------------------------------------------------------------------------------------------------------
---------------------------------------------------------------------------------------------------------------------------------------------------------------------------------------------------v----
-----------------------------------------------------------------------o-------------------------o------------------------------------------------------o------------------------------------------f----
--------------o--------------------------------------------------------------------------------o---------------------------------------------------------------------------------------------------f----
-M------------------------o--------------o-B-----o-------------o--------------------------------------------------o-------------o----------------------------------------o-------------------------f----
-------------------------------------M-------------------------------------------o--------------------------------------------------------------------------------o----------------------------?---f----
-----------------M-----------?--------------------------------------------------------------------------------------o---------------------------------o----------M-------------------oM------------f----
----------------------?----------------------------------------------------------------------------------------------------------------------------------------------------------------------------f----
m----------------------------------------------------------------------------------E--------------------------------------------------------------------------------------------------------E------X----
XXXXXXXXXXXXXXXXXXXXXXXXXXXXXXXXXXXXXXXXXXXXXXXXXXXXXXXXXXXXXXXXXXXXXXXXXXXXXXXXXXXXXXXXXXXXXXXXXXXXXXXXXXXXXXXXXXXXXXXXXXXXXXXXXXXXXXXXXXXXXXXXXXXXXXXXXXXXXXXXXXXXXXXXXXXXXXXXXXXXXXXXXXXXXXXXXXXXXXXX
