--------------------------------------------------------------------------------------------------------------------------------------------------------------------------------------------------------
--------------------------------------------------------------------------------------------------------------------------------------------------------------------------------------------------------
--------------------------------------------------------------------------------------------------------------------------------------------------------------------------------------------------------
--------------------------------------------------------------------------------------------------------------------------------------------------------------------------------------------------------
--------------------------------------------------------------------------------------------------------------------------------------------------------------------------------------------------------
--------------------------------------------------------------------------------------------------------------------------------------------------------------------------------------------------------
--------------------------------------------------------------------------------------------------------------------------------------------------------------------------------------------------------
--------------------------------------------------------------------------------------------------------------------------------------------------------------------------------------------------------
--------o----------o-o----------------o-------o-----o--oo------------o-------o----o---o---o--o--o------------------o--oo-o----o-------------o--------------o-----------------o---o----------o-----------
---------o?--B----B-----M-oB--o---B---M----o---oB-----M-o--?---o---?---?-----o-o-?-----------??----M-o-o----o---M--?Bo---o--??----oo--?-------o-----oB------?-?o-----?------o-------B-----B------o------
---------------M-M--------o---------o------o---B---B----o--B-----o---o-M-o----o-B-----MB-o-o---o----?--oo---B------?-M-oB------Boo---------?M-------------o------?oo--M---oo-----------M--o-------------
-----------------o---BT------o------oo----oTB--T-----o-Bo-?------------------o------o--M---B---o---------TMo-M-----o---o--o---B?------o---T-?o-------M--o---oo---o--------o-o?------o---Bo--oB---?------
v-----------------?---|------o--o----o-----|---|----------B------T--------------o--o------T--?--o--?-----T--M----o-----------------T?--o-M|-o----o--------o--TB------o-o-o---T-BMo----M--B--o-----------
f-------------T----T--|---------B-?--------|---|------B---------B|--B-----T?--------B-----|----M---------|----M-----B---?----------|---M--|--------------M---|-T---?--BT-----|------T?------------------
f-----E-------|--E-|--|--E-----------------|---|-----E-----------|---EE---|--------------E|----------E---|-E------E----------------|----E-|------------------|-|-E-----|E----|--E---|----------E-E------
fXXXXXXXXXXXXXXXXXXXXXXXXXXXXXXXXXXXXXXXXXXXXXXXXXXXXXXXXXXXXXXXXXXXXXXXXXXXXXXXXXXXXXXXXXXXXXXXXXXXXXXXXXXXXXXXXXXXXXXXXXXXXXXXXXXXXXXXXXXXXXXXXXXXXXXXXXXXXXXXXXXXXXXXXXXXXXXXXXXXXXXXXXXXXXXXXXXXXXXX
