--------------------------------------------------------------------------------------------------------------------------------------------------------------------------------------------------------
--------------------------------------------------------------------------------------------------------------------------------------------------------------------------------------------------------
--------------------------------------------------------------------------------------------------------------------------------------------------------------------------------------------------------
--------------------------------------------------------------------------------------------------------------------------------------------------------------------------------------------------------
--------------------------------------------------------------------------------------------------------------------------------------------------------------------------------------------------------
--------------------------------------------------------------------------------------------------------------------------------------------------------------------------------------------------------
--------------------------------------------------------------------------------------------------------------------------------------------------------------------------------------------------------
-------------------------------------------------------------------------------------------------------------------------------------------------------------------------------------------------------v
-------------oo-o----oo-----o---o-----oo-----o--oo--------o---o--o----o--o--o-------o---------------------oo----o------o--o--o----o-oo-----o-o-------------o-o---o-o-------o-o--o---o--------o---------f
------o----BoB-----o--B-?-?--o--?oo--M---o--o-BB----??--oo?o?M----oM-M-o?--M-?M----o-B?oo--B--oB-----MM-B-B-B-oM-o-?-?--oBo---------?oo-M?---o--oB------o--o----o-o-o-oo----?Bo-M-----------?o---M-----f
--------?----------o----------?------M--???M--B-----o----o-o-----o---?------o--------M-M-o--o-o-----Mo-----o-M-M-----------M--B-o----M------o----B?--o-oM---?o---oB--o---?--------------M?----BBo------f
----------M---o-----?----M-o----o---?--o-BM-------o-oo--Boo-------M----TT-B------TM---TT-----?---?---?o?-----------Bo-------o-----oo---M-??---MB----?B--oo-?o------o-?---o-oMooooo?o---o-?--M----------f
-------o----oo-------Boo---o------B--o?--o-----TT-oo?----?-o----?MTTo?-||--------|----||M-o-Moo----o----TT---o--------M------B-o-------o---B-----oo--o?M-----?o-?B----ooM-----MBM---B-B-MMTT----o------f
--------M------BMM-M-TT-B-------B------M--TTM--||-----------?-----||---||----?---|M---||--B--M--T-------||---?---M-M-----?----M----B---B-M---TT-?---M-TTB?----??------------B-------TT----||-----------f
m-E--------E--EEE-E--||-----EE-----E---E--||---||---------------E-||---||--E---E-|----||E--EE---|-E--E--||----------E--E-E-E-E--E---E--------||E------||-E----EE---E------------E---||---E||E-----EE--EX
XXXXXXXXXXXXXXXXXXXXXXXXXXXXXXXXXXXXXXXXXXXXXXXXXXXXXXXXXXXXXXXXXXXXXXXXXXXXXXXXXXXXXXXXXXXXXXXXXXXXXXXXXXXXXXXXXXXXXXXXXXXXXXXXXXXXXXXXXXXXXXXXXXXXXXXXXXXXXXXXXXXXXXXXXXXXXXXXXXXXXXXXXXXXXXXXXXXXXXXX
