--------------------------------------------------------------------------------------------------------------------------------------------------------------------------------------------------------
--------------------------------------------------------------------------------------------------------------------------------------------------------------------------------------------------------
--------------------------------------------------------------------------------------------------------------------------------------------------------------------------------------------------------
--------------------------------------------------------------------------------------------------------------------------------------------------------------------------------------------------------
--------------------------------------------------------------------------------------------------------------------------------------------------------------------------------------------------------
--------------------------------------------------------------------------------------------------------------------------------------------------------------------------------------------------------
--------------------------------------------------------------------------------------------------------------------------------------------------------------------------------------------------------
---------------------------------------------------------------------------------------------------------------------------------------------------------------------------------------------------v----
---------------------------------------------------------------------------------------------------------------------------------------------------------------------o-----------------o-----------f----
-------------------------o------------------------o---------o----------------------------------------------------------o---------------------------------------------------------------------------f----
--------o--------------------------------M-----?---------------------------------------------------------------o----------------------------------------------------------o------------------------f----
----------------------------------------o-----------------------------------------M-------------------------------------------------------------------------------------------o---------------B----f----
-------------------------------------------o-------------------M----------------------------------------------------B----------o-------------------------------------------------------------------f----
-------------TT---------------M----------------------------------------------------------------------------B---------------------------------------------------------------------------------------f----
m-------E----||---------------------------------------------------------------------E-----------------------------------------------------------------E--------------------------------------------X----
XXXXXXXXXXXXXXXXXXXXXXXXXXXXXXXXXXXXXXXXXXXXXXXXXXXXXXXXXXXXXXXXXXXXXXXXXXXXXXXXXXXXXXXXXXXXXXXXXXXXXXXXXXXXXXXXXXXXXXXXXXXXXXXXXXXXXXXXXXXXXXXXXXXXXXXXXXXXXXXXXXXXXXXXXXXXXXXXXXXXXXXXXXXXXXXXXXXXXXXX
