--------------------------------------------------------------------------------------------------------------------------------------------------------------------------------------------------------
--------------------------------------------------------------------------------------------------------------------------------------------------------------------------------------------------------
--------------------------------------------------------------------------------------------------------------------------------------------------------------------------------------------------------
--------------------------------------------------------------------------------------------------------------------------------------------------------------------------------------------------------
--------------------------------------------------------------------------------------------------------------------------------------------------------------------------------------------------------
--------------------------------------------------------------------------------------------------------------------------------------------------------------------------------------------------------
--------------------------------------------------------------------------------------------------------------------------------------------------------------------------------------------------------
-------------------------------------------------------------------------------------------------------------------------------------------------------------------------------------------------------v
---------------o----------o-o--o------------o---o-------------------o---o----o---o------o-----o---o----------o--------------------------oo-------ooo--------o----o--o-----o----o-----o-o-------o-------f
------M----?--------?-?-B--o----o?-------B---o--o----o-B-----oB--o----?-------BB----------?B-o--oo---B--?--o-o--ooo--oBM---o-?---M-o------??o-M-B-ooooM--M-?------M?--o----o----Bo-----o------B--------f
--------o--o-M-?M-o-o?o---B--o--?-M-------------?o--M--o---oBoo----B-o----------??-?-----B---------o-o?--M----M---M-----BM---M-?----------o-M-------?------o--M?-----o----o--M-M---B-oB----o-----------f
--------?--M?----T-M-o------o--?--------Mo-?o---Boo?-o?o----ooBo?o-----TB-?o-?--B--?---?---oo----?--o--T---oM--------o----T------?-o------o----o-B--B---?--Mo------M-Bo--?M--To----?--TBo---MT?-B------f
----------Bo--o-o|---M----o-M--T---M--B-oM-?-B---B--o--?-M-----T-M-o?-?|-----T------B-Moo-o----To--M?-o|--M----oo---T---oM|-M-oo----o------o--o-----o-oT---o-?---o--MooB--o--|---?----|--T---|o??o-----f
-------?-----B-M-|--M---------M|-------B-M---MM--M--M-M------?-|--T-?M-|--M--|--B-M--B---MM----|---B---|-----------B|-----|M-------------B--M??------?-|T-B-M--M-M------T----|--?-M---|--|---|---------f
m--EE-E--E-------|-----E-EE---E|--------E-------E--E---EE-E-E--|--|----|-----|--------E----E-E-|---E---|-----------E|-----|-----E-----E----------------||-----E-------EE|--E-|---EE---|-E|-E-|E-EE-----X
XXXXXXXXXXXXXXXXXXXXXXXXXXXXXXXXXXXXXXXXXXXXXXXXXXXXXXXXXXXXXXXXXXXXXXXXXXXXXXXXXXXXXXXXXXXXXXXXXXXXXXXXXXXXXXXXXXXXXXXXXXXXXXXXXXXXXXXXXXXXXXXXXXXXXXXXXXXXXXXXXXXXXXXXXXXXXXXXXXXXXXXXXXXXXXXXXXXXXXXX
