--------------------------------------------------------------------------------------------------------------------------------------------------------------------------------------------------------
--------------------------------------------------------------------------------------------------------------------------------------------------------------------------------------------------------
--------------------------------------------------------------------------------------------------------------------------------------------------------------------------------------------------------
--------------------------------------------------------------------------------------------------------------------------------------------------------------------------------------------------------
--------------------------------------------------------------------------------------------------------------------------------------------------------------------------------------------------------
--------------------------------------------------------------------------------------------------------------------------------------------------------------------------------------------------------
--------------------------------------------------------------------------------------------------------------------------------------------------------------------------------------------------------
--------------------------------------------------------------------------------------------------------------------------------------------------------------------------------------------------------
------------------------o--o----------o---------------o-------------o--------------------o-------o----------------o----o-o---------------o------o------o-o------o-----------o----o---------o---o--------
---------BM-B-o---o--------B-----o-----Mo--?-o---B---?o------o--?--o-B-M---B----o-------o---?-o--M---B----?-o--B------?M-----------?-?-o-o----B--o-?--o-M-----?-----oB--o----?--M----o---?-------o------
---------o--o---------B--------?--Mo----oo-M----B--o----?---o--o---o-------o-----------o--o--------o-----o---?-?--o-------------oo---M--------o-M----Boo-M?--------------??o--o----o---------o----------
-------o---------oM-----To------BB------o---o--T-o----------T-?---M-----oT---T----B-M--o---?oo--o---o---M--------------------o---o-------M------o----o-o-M-------To----B----o-----T-o-o----M--T---------
----------BM---o------o-|-----T-------B----M---|-------B----|---------M-o|---|-----o--------oo---?-o-o--T--o--o----Bo--o---oo-o--?---o--B--B-oMo------voo--T-----|----o-o------o--|o----T-----|?--------
----------?---------?---|-----|--M--------T----|-------T----|----T--M----|---|-M----------------M-------|-TB-------B----------------------------M-M-?-T--B-|-----|-----T-B--------|-----|-----|B--------
m------------------E----|----E|-----------|----|----E--|----|E---|-------|---|--------------------------|-|-----------E-----------E-------------------|E---|-----|--E--|--E-------|-----|-----|---EE----
XXXXXXXXXXXXXXXXXXXXXXXXXXXXXXXXXXXXXXXXXXXXXXXXXXXXXXXXXXXXXXXXXXXXXXXXXXXXXXXXXXXXXXXXXXXXXXXXXXXXXXXXXXXXXXXXXXXXXXXXXXXXXXXXXXXXXXXXXXXXXXXXXXXXXXXXXXXXXXXXXXXXXXXXXXXXXXXXXXXXXXXXXXXXXXXXXXXXXXXX
