--------------------------------------------------------------------------------------------------------------------------------------------------------------------------------------------------------
--------------------------------------------------------------------------------------------------------------------------------------------------------------------------------------------------------
--------------------------------------------------------------------------------------------------------------------------------------------------------------------------------------------------------
--------------------------------------------------------------------------------------------------------------------------------------------------------------------------------------------------------
--------------------------------------------------------------------------------------------------------------------------------------------------------------------------------------------------------
--------------------------------------------------------------------------------------------------------------------------------------------------------------------------------------------------------
--------------------------------------------------------------------------------------------------------------------------------------------------------------------------------------------------------
--------------------------------------------------------------------------------------------------------------------------------------------------------------------------------------------------------
---------o--o-------o--------oo-o-o------------o--o---ooo---o---------o------------o-o------o---------------o------oo---------o-------o-----o---o-----------------o--o-----o--o-------------o-----------
---------?---o--o---o-----B------B--oo-?--?---B----o?Moo-------B----?--------Bo-----o-Bo-o--------?----B--o?o-MMB--o--------B--oo---------o------?-----?-oo-o-----BM----B-----------o----?--------------
-----------------oo------?------------M--?o--o----o------o--------?B-o-------o---BM-o------------Bo---o--?o--o---?---?Mo-----o--------M----o?--o-------?-----o-------ooB?-o-----?---vB-M------?-o-------
--------?-o--B-o----------o----------o-o-----o-----?-------T-?-----??-----------o-o----o--o---oT------?-----------B-----oB---o--o-To--oTM-o---o------T------T----oM---B----------M--f-?----o------------
--------o--o----?o-T--Bo------M-----------?---o--o-----?o--|---?--B---ooT-----M------T--oo-----|---oo-----oB---?------oT------o?--|---B|---o-o--o---o|-B---o|---o----To-o------B----f-o-o---o-M-o-------
-------------------|-M---T------?-------?---------?--?--B--|--M----T----|-------?--M-|-?-M---T?|-------M---------------|---B------|----|B------T--?--|------|?--M----|----------M---f---T--T------------
m-----------------E|--E--|-----E-----------E-E-E-----------|-------|----|------------|-------|-|---E-------------------|----------|----|----E--|----E|--E---|--------|-------------Ef-E-|--|-----E------
XXXXXXXXXXXXXXXXXXXXXXXXXXXXXXXXXXXXXXXXXXXXXXXXXXXXXXXXXXXXXXXXXXXXXXXXXXXXXXXXXXXXXXXXXXXXXXXXXXXXXXXXXXXXXXXXXXXXXXXXXXXXXXXXXXXXXXXXXXXXXXXXXXXXXXXXXXXXXXXXXXXXXXXXXXXXXXXXXXXXXXXXXXXXXXXXXXXXXXXX
