--------------------------------------------------------------------------------------------------------------------------------------------------------------------------------------------------------
--------------------------------------------------------------------------------------------------------------------------------------------------------------------------------------------------------
--------------------------------------------------------------------------------------------------------------------------------------------------------------------------------------------------------
--------------------------------------------------------------------------------------------------------------------------------------------------------------------------------------------------------
--------------------------------------------------------------------------------------------------------------------------------------------------------------------------------------------------------
--------------------------------------------------------------------------------------------------------------------------------------------------------------------------------------------------------
--------------------------------------------------------------------------------------------------------------------------------------------------------------------------------------------------------
---------------------------------------------------------------------------------------------------------------------------------------------------------------------------------------------------v----
-------------------------o-------------------------------o-------------------------------------------------------------------o---------------------------------------------o-----------------------f----
-----------------o---------------------------------------------------------------------------------------------------------------------------------------------------------------------------------f----
-------------------------------------------B----------------------------------------------------------------------------------------------------------------o--------------------------------------f----
-----------------------------------------------------------------TT--------Mo------------------------o------TT----------------------------------------------------o-------o--------------------B---f----
---------B-------------------------------------------------------||----------------------------o------------||--o----------------------TT--------------B-o--------M--------------------------------f----
-----------------------------------------------------------------||---?-------------------------------------||--?----------------------||--------TT---------------------M----------------M---------f----
m----------------------------------------------E-----------E-----||--------------E-----------------E--------||----------E----------E---||----E---||--E------------E--------------------------------X----
XXXXXXXXXXXXXXXXXXXXXXXXXXXXXXXXXXXXXXXXXXXXXXXXXXXXXXXXXXXXXXXXXXXXXXXXXXXXXXXXXXXXXXXXXXXXXXXXXXXXXXXXXXXXXXXXXXXXXXXXXXXXXXXXXXXXXXXXXXXXXXXXXXXXXXXXXXXXXXXXXXXXXXXXXXXXXXXXXXXXXXXXXXXXXXXXXXXXXXXX
