--------------------------------------------------------------------------------------------------------------------------------------------------------------------------------------------------------
--------------------------------------------------------------------------------------------------------------------------------------------------------------------------------------------------------
--------------------------------------------------------------------------------------------------------------------------------------------------------------------------------------------------------
--------------------------------------------------------------------------------------------------------------------------------------------------------------------------------------------------------
--------------------------------------------------------------------------------------------------------------------------------------------------------------------------------------------------------
--------------------------------------------------------------------------------------------------------------------------------------------------------------------------------------------------------
--------------------------------------------------------------------------------------------------------------------------------------------------------------------------------------------------------
--------------------------------------------------------------------------------------------------------------------------------------------------------------------------------------------------------
--------------------oo---o---------------o-o----o------o-----------o-------------o---o---------o----o--ooo------------o---o-------o--------oo-o-o-oo-------o----o---------------------oo----------------
-------o?---------ooo-------------o--B--?-ooM--?--B-o----o?-o--?ooo-BBo----o------?-----?--------o-----?----Moo--o?o-o-o---?---oB----o--?oo---?o--?-ooo--B---o--oB----o-------o-Mo-?--?--MoB--o---------
-------o?--o-----o-------o----Boo-----o-Bo----o---M---o----------------------o-BM--------o-B---------?------Bo-----------------------o-M---?--o---------o----oo--o-----oo----o-----?---M------ooo-------
-------o--MoB-----o-----M--------o---T-?---------To--o---?----------------T----o---oM---------o--?o--o------T-?TM---o-------T--M--MM?-T--?Moo-----M-M-o--B---Boo------o--T--------------T-B------o------
--------B--------?o-o-M----o?--?-MB-o|---------?-|---o-o--o--T--oo-o----M?|--o----o-B----o-TBo---o-ov---M---|--|------T-----|----o----|o---o-o-M---oM---M-o?----o-------o|o-------TMo---|o--B-----------
-----------------?---B-------T-------|---T--B----|-----------|------------|-----M--B-----BM|B------?f-------|--|------|-----|---T----?|-------------------------------?--|B-----M-|-----|---------------
m-----------EE----E----------|E--E---|---|------E|E-E--------|-E----------|----------------|--------f--E-E-E|-E|--E---|-----|---|-----|E-E--E----------------E--E-----E--|--------|-----|---EE----------
XXXXXXXXXXXXXXXXXXXXXXXXXXXXXXXXXXXXXXXXXXXXXXXXXXXXXXXXXXXXXXXXXXXXXXXXXXXXXXXXXXXXXXXXXXXXXXXXXXXXXXXXXXXXXXXXXXXXXXXXXXXXXXXXXXXXXXXXXXXXXXXXXXXXXXXXXXXXXXXXXXXXXXXXXXXXXXXXXXXXXXXXXXXXXXXXXXXXXXXX
