--------------------------------------------------------------------------------------------------------------------------------------------------------------------------------------------------------
--------------------------------------------------------------------------------------------------------------------------------------------------------------------------------------------------------
--------------------------------------------------------------------------------------------------------------------------------------------------------------------------------------------------------
--------------------------------------------------------------------------------------------------------------------------------------------------------------------------------------------------------
--------------------------------------------------------------------------------------------------------------------------------------------------------------------------------------------------------
--------------------------------------------------------------------------------------------------------------------------------------------------------------------------------------------------------
--------------------------------------------------------------------------------------------------------------------------------------------------------------------------------------------------------
-------------------------------------------------------------------------------------------------------------------------------------------------------------------------------------------------------v
-------o--------------o----ooo--o-------oo-o-o----o-----------o------o-o-o---o------o----o--------o----o-----o----o-----o---------------o-o-----o--------o---o---oo--o----o---o---o------o--oo-o-------f
------?-------o--BMoo-M-Bo---?ooo???o---M--o?o---B--oB-----o-B-o----B?-B-oo-o----Bo--M?-o--Bo-----B-o---?-----B--o---?--?-oB----?M-o---?oooooMo--?-??-ooB-oM----?--M--?ooMMo??Bo----?BM---o-o---BM-----f
------ooo-o-oo---?-?-??--M--ooo-----Mo-------oB-o--B-----B-B-Boo--o---o------oM----oo--o----B--oooB?--o---M--o---o---------B-M-----Boo--ooo-M------------o-o--o-ooMo-o----M-o-M-o-o-?------?-o--B------f
-------oo-----oMT---M--o-oT----?o-----M?M--o------oT-o--B--oT------MooB-o-o?--o-?-----o----MB--M--------o--ooMoo--------o---o----o-?o-o--?TB?---o?ToMoo-o--B?o----M---o--o--M--ooooM------Mo--?-T------f
------o---B--ooT|--o-o-o--|To----oM-MB--M---B-oMoB-|-Bo-M-oMT-oo---M-Mo-?-ooMo-o---??o-M-TB---ooooBo--B--T-----------M---?-----oo-oT-Mo-M-|MToo-oB|---M?oo-?o--o-------oB-oBM---?oM-T----o?-Bo-o|------f
-------------?-||---?-----||-----M--T-B----M-------|---?BM--|-----?-M?T-?---T------?TM--B|----?-----M--M-|-------T-----------BM----|M-----|-|T----|-------B------T----TMT-M------B--|-?--M--M---|M-----f
mEE-EE-E-E---EE||E--E----E||----E---|-E---EE---EE--|--------|--EE----E|EE---|-------|----|----------E----|-------|--E-----E--------|------|E||----|-------------E|E--E|-|-----------|-E---------|------X
XXXXXXXXXXXXXXXXXXXXXXXXXXXXXXXXXXXXXXXXXXXXXXXXXXXXXXXXXXXXXXXXXXXXXXXXXXXXXXXXXXXXXXXXXXXXXXXXXXXXXXXXXXXXXXXXXXXXXXXXXXXXXXXXXXXXXXXXXXXXXXXXXXXXXXXXXXXXXXXXXXXXXXXXXXXXXXXXXXXXXXXXXXXXXXXXXXXXXXXX
