--------------------------------------------------------------------------------------------------------------------------------------------------------------------------------------------------------
--------------------------------------------------------------------------------------------------------------------------------------------------------------------------------------------------------
--------------------------------------------------------------------------------------------------------------------------------------------------------------------------------------------------------
--------------------------------------------------------------------------------------------------------------------------------------------------------------------------------------------------------
--------------------------------------------------------------------------------------------------------------------------------------------------------------------------------------------------------
--------------------------------------------------------------------------------------------------------------------------------------------------------------------------------------------------------
--------------------------------------------------------------------------------------------------------------------------------------------------------------------------------------------------------
--------------------------------------------------------------------------------------------------------------------------------------------------------------------------------------------------------
-------------o----------------o------o-------------------o--------o------------------o-----oo---o---------o--------oo----------------oo---------------------o-----o-------o------o---o-----o------------
---------o--B-------o--?o-----M?-Bo----?-o----?oo-B--o-----M----oo---?-----Bo-------?-M--------?------o----B--------B---M-M------Bo-?--o-o-M-B-------M?--------?--------------?---?-----------o---------
------------B--------o-----o------o--o--o-----o---o-?o--o---M---M-----o-o----------?-----o---B-M-o--o?--oo-M------------------o--o--o---Mo--o-------o-----o-------o----o---o---?-B----oM----?B----------
--------B---------o---o-------o----oT--Bo--o------o-Too-o----oBoo--------------o----o-o--------------o---------------B----T--------------o-o----------o---?----o-----o-?o--------B-Bo-o----T-----M------
--------?------BBo----oM---T--oo----|----oo--?o-----|-M--------o----------o-T--o------o--o---Bo----o----------M----T----o-|-o--?----oo-----------M----vB------------T------Mo---o--T-------|----o?------
-------------MT------------|B-----T-|---------?-----|-?---------------------|---B---M?-----T--T---------------M--M-|------|---------------B---B-------f--------M---M|--T-----?--M--|-------|-----M------
m-------E----E|------E-----|------|-|---------------|---------------------E-|E-------------|--|E--------------E--E-|------|---------E-----------------f-----E--E----|--|-----------|-------|-----E-E----
XXXXXXXXXXXXXXXXXXXXXXXXXXXXXXXXXXXXXXXXXXXXXXXXXXXXXXXXXXXXXXXXXXXXXXXXXXXXXXXXXXXXXXXXXXXXXXXXXXXXXXXXXXXXXXXXXXXXXXXXXXXXXXXXXXXXXXXXXXXXXXXXXXXXXXXXXXXXXXXXXXXXXXXXXXXXXXXXXXXXXXXXXXXXXXXXXXXXXXXX
