--------------------------------------------------------------------------------------------------------------------------------------------------------------------------------------------------------
--------------------------------------------------------------------------------------------------------------------------------------------------------------------------------------------------------
--------------------------------------------------------------------------------------------------------------------------------------------------------------------------------------------------------
--------------------------------------------------------------------------------------------------------------------------------------------------------------------------------------------------------
--------------------------------------------------------------------------------------------------------------------------------------------------------------------------------------------------------
--------------------------------------------------------------------------------------------------------------------------------------------------------------------------------------------------------
--------------------------------------------------------------------------------------------------------------------------------------------------------------------------------------------------------
-------------------------------------------------------------------------------------------------------------------------------------------------------------------------------------------------------v
------o-------o-----------o---o----o--------o--o----o--o---o-oo--o--o--------oo---o--o-o--o----oo-----o--------------oo-------o---o------------o-----o-oo----o---o-------o--------oo--o--oo--oo--------f
---------B--M?--M---oBB-------o?o-o---M---M--?oM---?-Bo-o-o-B----ooo-M-BB?BoM----o--BMM-oMo---?o?-?-o-M?B-?o----o--B-o---B-?-?---?------o--B--B-Mo-o?-oB-B-o-B-Bo--oo-o----B-------oB-----BM---o-------f
-------?------B--o-B------o-----------oo---B-M----M------B--------M-Bo--o-?B-oB-oo?o--Mo------M-o--o---------o-------?---o-Bo-----o-??-o-------MM-Mo--------o---o---------o------o--M---o-----B?-------f
-------------?---------B-------------?M---o-----o-o---o-M?------oB-o---ooB?o?---oooM-?----o----oM-o-M----o--o------MB---?-------M---------------o--oB------------o?----B-M--o-MM---o-o----o--?---------f
------------B-T------B?------oo-oT--MB-o------M----?--M---ooMTM-o?--o-o------oTBo-B-M----B---T-o---?-o-o-B---o-M-M--?o--o-o-----o-oB-o----T-----o-To-----?B?--M-oM-B-T-----o-----MM---B-----B---o------f
------------B-|----------M-------|-----M-----------M---------|------B?T-M--M--|-----------T--|-----T--M--?-----?-------?B-B--------M-----M|---BM--|M----T?-------?---|----------------T----T-----------f
m-E--E-EEE-E-T|E-E--E----T--E-EET|----ET--E-----------EEEE--E|E-TE---E|--E-E-E|-E---------|--|-----|-----E---EE---E----E-T-----------E--E-|---E-E-|-----|-----EE----E|------E-E---E---|-E--|EE---E-EE--X
XXXXXXXXXXXXXXXXXXXXXXXXXXXXXXXXXXXXXXXXXXXXXXXXXXXXXXXXXXXXXXXXXXXXXXXXXXXXXXXXXXXXXXXXXX|XXXXXXXXXXXXXXXXXXXXXXXXXXXXXXXXXXXXXXXXXXXXXXXXXXXXXXXXXXXXXXXXXXXXXXXXXXXXXXXXXXXXXXXXXXXXXXXXXXXXXXXXXXXXX
