--------------------------------------------------------------------------------------------------------------------------------------------------------------------------------------------------------
--------------------------------------------------------------------------------------------------------------------------------------------------------------------------------------------------------
--------------------------------------------------------------------------------------------------------------------------------------------------------------------------------------------------------
--------------------------------------------------------------------------------------------------------------------------------------------------------------------------------------------------------
--------------------------------------------------------------------------------------------------------------------------------------------------------------------------------------------------------
--------------------------------------------------------------------------------------------------------------------------------------------------------------------------------------------------------
--------------------------------------------------------------------------------------------------------------------------------------------------------------------------------------------------------
-------------------------------------------------------------------------------------------------------------------------------------------------------------------------------------------------------v
--------B-----------------------o------------------------------------------------B-BB---------o-------------------------------------------------X--B----------?B?B?-----------------------B------------f
--------------------------------------------X-?----o---------BB?--BB?B??-?-?BBB?--------------------------------------B?M---?B??-----------------------------------------------BB----------------------f
------o-------o------o-o-------------?BB??B?---------MBB--M?----o--------------------------o----------------------------o---------------BBo-B-o-------------------------------------X-------M-BBB------f
----o----------------------o--T------------------T-------T----------------o--M?B??-?---------------X---o------X----?-----------------------T--B-??--X---M-X--------X------T--------------------o-------f
-------------------B----------|----------?B???---|-------|---------------o-------------------o---T-XX----M?--XX--------BB-B?------BBBT--M?o|-o-----?XX------o-------------|---X--------To--------------f
-------------T---T------------|---T--T-----------|-------|----------o-T--------------------------|-XXXo-----XXX----o---------------o-|-----|----oo--XXX-------------------|------------|---------------f
m-E----------|---|------------|--E|--|-----------|-------|------------|--------------------------|-XXXX----XXXX-----------E----------|--XX-|-------EXXXX------------------|------------|--------------XX
XXXXXXXXXXXXXXXXXXXXXXXXXXXXXXXXXXXXXXXXXXXXXXXXXXXXXXXXXXXXXXXXXXXXXXXXXXXXXXXXXXXXXXXXXXXXXXXXXXXXXXXXXXXXXXXXXXXXXXXXXXXXXXXXXXXXXXXXXXXXXXXXXXXXXXXXXXXXXXXXXXXXXXXXXXXXXXXXXXXXXXXXXXXXXXXXXXXXXXXX
