--------------------------------------------------------------------------------------------------------------------------------------------------------------------------------------------------------
--------------------------------------------------------------------------------------------------------------------------------------------------------------------------------------------------------
--------------------------------------------------------------------------------------------------------------------------------------------------------------------------------------------------------
--------------------------------------------------------------------------------------------------------------------------------------------------------------------------------------------------------
--------------------------------------------------------------------------------------------------------------------------------------------------------------------------------------------------------
--------------------------------------------------------------------------------------------------------------------------------------------------------------------------------------------------------
--------------------------------------------------------------------------------------------------------------------------------------------------------------------------------------------------------
-------------------------------------------------------------------------------------------------------------------------------------------------------------------------------------------------------v
----------oo-o-oooooo---o-oo-o----------o--------oo-oo--o-o---oo--o-----o-oo-o-----o---o---oo-o-o--o-----o-oooo-o-o-o-oo---o-----o-o--o----o--oo--o-oo-oo---o-o---o-o-o--o----o------o---oo----oo------f
-------o--------o-o----------oo-o-o------------o-------ooo--oo----o---o--------o------o--o-ooo---oo-----------oo-oo------o---o-oo----o--ooo-oo-------o-------o-o---o-o---o-o------o--o-----o---oo------f
-------oooo--o-o--o--o-----o--o-------o-oo----o-o--o----o------------o----oo-o--o-oo-o-o----o-o-----o-o--o---------o-o-o--oo------oo-o------o--o-o----------o--o-------oo--o----o-oo-----o-------------f
------------oo-oo---oo-o--o-------ooo---------------o------oo------o-----o---oo------oo---o---o-----o-o-------------oo-oo-o--o-o----------------o--o----------------o-----------oooo------o------------f
-------oTo-o-T--o---o-T---oT----o--ooo--To---T----o--TTooo-oTT--o--o--ToT---o---TToTT-oo--ooo---ToT-ToT-------o-To---To----o--ooo-oTo-----------To-T--ooT-ToTo--T---T-----oT---oo---T-T----o--To-o-----f
--------|----|--------|--T-|--TTT-T-TT--|-TT-|---T---||-----|T--------|-|------TT|T|T-----------|-|-|-|---------|--T-|--TTT-T-T---T|-------T----|--|T--TT-|-|--T|T--|-----T|--------|-|-------|--------f
m-----E-|-EE-|-E------|--|-|--|||-|-||-E|-|TE|T-T|-T-||-ETT-||E-TET-E-|ET-EE---||T|||-T--T-T----|-|-|T|--EETE-E-|--|E|TT|||T|-|TE-||TE-EEE-|---E|EE|T--|T-|-|--|||EE|E----||-E--EEE-|-|--TEE--|--------X
XXXXXXXXXXXXXXXXX---XXXXXXXXX--X|XXX|XXXXXXXXXXXXXXXXXXXXX--XXXXXXXXXXXXXXXXXXXXXX---XXXXXXXXXXXXXXXXXXXXXXXXXXXXXXXX|XXXXX|XXXXXXXX|XXXXXX|XXXXXXXXXXXXXXXXXXXXXXXXXXXXXXXXXXXXXXXXXXXXXXXXXXXXXXXXXXXX
