--------------------------------------------------------------------------------------------------------------------------------------------------------------------------------------------------------
--------------------------------------------------------------------------------------------------------------------------------------------------------------------------------------------------------
--------------------------------------------------------------------------------------------------------------------------------------------------------------------------------------------------------
--------------------------------------------------------------------------------------------------------------------------------------------------------------------------------------------------------
--------------------------------------------------------------------------------------------------------------------------------------------------------------------------------------------------------
--------------------------------------------------------------------------------------------------------------------------------------------------------------------------------------------------------
--------------------------------------------------------------------------------------------------------------------------------------------------------------------------------------------------------
-------------------------------------------------------------------------------------------------------------------------------------------------------------------------------------------------------v
--------B-----------------------o------------------------------------------------B--B---------o-------------------------------------------------X--B----------?B?B?-----------------------B------------f
---------------B----------------------------X-?----o---------BBB--B?BBB?-M-??BB?--------------------------------------B??---?B??-----------------------------------------------??----------------------f
------o-------o------o-o-------------BB???BB---------MBB--??-------------------------------o----------------------------o---------------B?--?o--------------------------------------X-------MBBB?------f
-o-------o-----------------o--T------------------T-------T---o------------o--M?BBB-?---------------X----------X----?-----------------------T--B-??--X---?-X--------X------T----------------------------f
-------------------B----------|----------BB???---|-------|-------------o-o-------------------o---T-XX----B?--XX--------?B-B?------BBBT--MBo|-o------XX--------------------|---X--------T---------------f
-------------T---T------------|---T--T-----------|-------|----------o-T-o------------------------|-XXXo-----XXX-o--------------------|-----|----o---XXX-------------------|------------|--------o--o---f
m------------|---|------------|--E|--|-----------|-------|------------|E-------------------------|-XXXX----XXXX-----------E-----E----|--XX-|--------XXXX------------------|------------|--------------XX
XXXXXXXXXXXXXXXXXXXXXXXXXXXXXXXXXXXXXXXXXXXXXXXXXXXXXXXXXXXXXXXXXXXXXXXXXXXXXXXXXXXXXXXXXXXXXXXXXXXXXXXXXXXXXXXXXXXXXXXXXXXXXXXXXXXXXXXXXXXXXXXXXXXXXXXXXXXXXXXXXXXXXXXXXXXXXXXXXXXXXXXXXXXXXXXXXXXXXXXX
