--------------------------------------------------------------------------------------------------------------------------------------------------------------------------------------------------------
--------------------------------------------------------------------------------------------------------------------------------------------------------------------------------------------------------
--------------------------------------------------------------------------------------------------------------------------------------------------------------------------------------------------------
--------------------------------------------------------------------------------------------------------------------------------------------------------------------------------------------------------
--------------------------------------------------------------------------------------------------------------------------------------------------------------------------------------------------------
--------------------------------------------------------------------------------------------------------------------------------------------------------------------------------------------------------
--------------------------------------------------------------------------------------------------------------------------------------------------------------------------------------------------------
-------------------------------------------------------------------------------------------------------------------------------------------------------------------------------------------------------v
------o----------o---o--o------------o--o-------o-----o--------------o------oo--o--o---------oo--o-------o----o---------------------------o--o-o-o---------oo---------o----------o---oo----------o-----f
---------oo-o------o---oo----------o--------------------o----------------------o----o----o---o-----------ooo----------o---o-o----------------------oo-o------o-----o-------o--o-oo-o---o--oo--o--------f
-------------------------------------o--o---o-------oo---o-o-o--o---o-----------o----o--------o---o---------o---------------o--------o----oo-------------o-o---o---oo-----o----o--o-----o----o---o-----f
------o----oo---------------o--oo----o------oo-o-----o-oo---o------o--o------o-o----oo----o---o---oo--oo--o-o----o------o-----------o--o-oo-----o---o-----------ooo-------o-o-oo-----------------------f
--------T-o----o-T---------T-o----oT---T-TT----oT--T--o---oo---T-------T--o-o-T-----T-----o-----T------T------oo-----o--------T-----Too--o-o-T-o-oo-o--------o-----o--T-----o--o----o---T-o------T-----f
--------|--------|---------|T---T--|-T-|-||--T--|--|---T---T---|T-----T|----T-|-T---|T----------|---T-T|------------T---------|-----|--------|----T-----------T---T---|--T-------T------|-TT-----|-----f
m-------|-E------TE-T--T---||E-E|EE|T|-|E||--T--|E-|E--|---|TT-||----E||--E-|E|-|-T-||T--EE-E--E|--E|E||E------E-EE-|-EEE-EE--|T-T--TE--E-EEE|--EE|-E-ET-E-T--|---|---|E-|E-E-ET-|--T-T-TT||-TE--|-----X
XXXXXXXXXXXXXXXXXXXXXXXXXXXXXXXXXXXX|XXXXXXXXXXX|XXXXXXXXXX--XXXXXXXXXXXXXXXXXXXXXX--XXXXXXXXXXXXXXXXXX|XXXXXXXXXX--XXXXXXXXXXX|XXXX|XXXXXXXX|XXXXXXXXXXXXXXXXXXXX|XXXXXXXXXXXXXXXXXXXXXXXXXXXXXXXXXXXXX
