--------------------------------------------------------------------------------------------------------------------------------------------------------------------------------------------------------
--------------------------------------------------------------------------------------------------------------------------------------------------------------------------------------------------------
--------------------------------------------------------------------------------------------------------------------------------------------------------------------------------------------------------
--------------------------------------------------------------------------------------------------------------------------------------------------------------------------------------------------------
--------------------------------------------------------------------------------------------------------------------------------------------------------------------------------------------------------
--------------------------------------------------------------------------------------------------------------------------------------------------------------------------------------------------------
--------------------------------------------------------------------------------------------------------------------------------------------------------------------------------------------------------
----------------------------------------------------------------------------------------------------------------------------------------------------------------------------------------------v---------
---------o---------o---o-o-o----------------------------o----------------o-----------------oo-------------o---o---------o--o----o------o--o-----oo--------------o-o--o---------------o-ooo----f---------
---------?M------M-----B---B----M----o---?----oB--o------oM--B----B----oB-o?-?-o---------?-M---o-----B-?o-----oM?o-o--o---?-o---o---------?----o-----?---o-o--oB---oo-------B---M---------?--of--o------
---------o----B-o----o--oo---o-o----Mo----?----------B-------o--Mo--B-----M--?----o---------B-ooB----B-o-------------o-----oB-?---o-o-o--o?----------o--------------o-----o-------o---------oof--o------
-----------o---?--o--o------o-ooo------o-------oo--o--------?------o---o---oo-------------T--o-o-o----o-o--o--------MM---------M--------B----TM--o-----M-------?-----B-o--M----------BoM--o---f---------
-------B---o----Mo-----oo--o------o--??------T-T------o--ooM-o-T---------------T--B-------|------oo?-----o--T---?-o-T-------------Bo------o--|------o----?-----T----------T---B---o-BM---?o--?f---------
-----------------------------------------?---|-|-------------T-|M-----?------T-|----------|----M--B---------|-------|B-B---------------------|---?BB--B--------|-----?---M|------------M-----?f?--------
m-------------E------EE----------------------|-|-------------|-|-------------|E|-----E----|-------------E---|-------|-------E------------E---|-----------------|--------E-|E---E-------E------X---------
XXXXXXXXXXXXXXXXXXXXXXXXXXXXXXXXXXXXXXXXXXXXXXXXXXXXXXXXXXXXXXXXXXXXXXXXXXXXXXXXXXXXXXXXXXXXXXXXXXXXXXXXXXXXXXXXXXXXXXXXXXXXXXXXXXXXXXXXXXXXXXXXXXXXXXXXXXXXXXXXXXXXXXXXXXXXXXXXXXXXXXXXXXXXXXXXXXXXXXXX
