--------------------------------------------------------------------------------------------------------------------------------------------------------------------------------------------------------
--------------------------------------------------------------------------------------------------------------------------------------------------------------------------------------------------------
--------------------------------------------------------------------------------------------------------------------------------------------------------------------------------------------------------
--------------------------------------------------------------------------------------------------------------------------------------------------------------------------------------------------------
--------------------------------------------------------------------------------------------------------------------------------------------------------------------------------------------------------
--------------------------------------------------------------------------------------------------------------------------------------------------------------------------------------------------------
--------------------------------------------------------------------------------------------------------------------------------------------------------------------------------------------------------
-------------------------------------------------------------------------------------------------------------------------------------------------------------------------------------------------------v
------o---------o-----------------------------------o-----oo----------o-o---o---o----oo---ooo-------------o-------------o-oo-o-o-----o--o-o--oo--o----ooo-o-o---o--o----o------o----o-o---------o------f
------oB-o---o?---oo---oMo-----B-Bo------------B?oB--?-?-----?--o--oo?-o-o?---o-Moo--B-----o--?--?--B--B--?-B--------o--M??o---o--B--oo-oo-BB--Mo-----------?---?-?--o----?--M--oo-MBBoo----o----------f
-------o----o-M-?--BBo-----M-??--?---B-?--o-?M------M--?--o--o--o-oo--MB?-oo-------------o--M-----oo?M--oB-------?--o--o-M-----------o-o?---o--?-----?----?M--o-Moo-----M---B?M-o----o----o----B?------f
----------o---oo----M---------o-B-MM?o---M-B-BT?-BTo-o---o-MT-MB---B--o--?-?Tooo-oo--B-B---T----o?o----?---o--M---o-------o------B---TMo----Bo---M?-----?o----oB------B---o?-----o----o-o------T-o-----f
------BM-Bo----MMoo---o----B----------oM----o-|---|M-o-oM-?-|--?oB--------o-|BM?o?--Booo---|---o-o-M-M?oo---TM----B-oooo--Mooo-To----|B?----TM-B-o-?-o----Mo--o-To----oMBT---oo----BM?-----M---|B?-----f
---------B--------BBT-------B----M--------B?B-|---|--------T|---------B-----|-----------B--|?-M-?MM-T-T--M--|-B--------?-------|----M|------|B--B---B-T-B----MB-|--M?----|----?---M------------|-------f
m---EE--EE--E-E---EE|--------------E--E--EE-EE|-E-|---E----||--E---EE-------|----E---------|---E-E--|-|E--EE|------------EE----|---E-|E--E--|--E-----E|--E---E--|--------|--EEE-EE----E-E------|--E----X
XXXXXXXXXXXXXXXXXXXXXXXXXXXXXXXXXXXXXXXXXXXXXXXXXXXXXXXXXXXXXXXXXXXXXXXXXXXXXXXXXXXXXXXXXXXXXXXXXXXXXXXXXXXXXXXXXXXXXXXXXXXXXXXXXXXXXXXXXXXXXXXXXXXXXXXXXXXXXXXXXXXXXXXXXXXXXXXXXXXXXXXXXXXXXXXXXXXXXXXX
