--------------------------------------------------------------------------------------------------------------------------------------------------------------------------------------------------------
--------------------------------------------------------------------------------------------------------------------------------------------------------------------------------------------------------
--------------------------------------------------------------------------------------------------------------------------------------------------------------------------------------------------------
--------------------------------------------------------------------------------------------------------------------------------------------------------------------------------------------------------
--------------------------------------------------------------------------------------------------------------------------------------------------------------------------------------------------------
--------------------------------------------------------------------------------------------------------------------------------------------------------------------------------------------------------
--------------------------------------------------------------------------------------------------------------------------------------------------------------------------------------------------------
-------------------------------------------------------------------------------------------------------------------------------------------------------------------------------------------------------v
-------------oo---o------o------o------o-----------o-------oo---------o-o----------------------------------o----o---o---o---o----o--o-o----o-----------o---oo-------------oo-o-o-o---------o---o-o-----f
-----------o---oo---o--o--oo--o--o--oo-----o---------------o-------o----------o----oo-------------o----------oo--o-----o---o---o----o----o---o-----------oo--ooo-o-o-o------o-------------ooo---o------f
------ooo------o------o--o--------------oo-o---o----oo--o-----o-----o---------------ooo---------------------------------o------oo--o---oo-o-o----o--o-o----o--------o--oo--o---o---------oo-o--oo------f
---------o-o-----o----------o--o-----o-oo------o---o----------------------------oo-------oo-oo-----------o----o------------o------o--o---o-----o--oooooo---------------------oo--o----o----------------f
--------T-oo---o-T--T-o-----oo-o----To--o-To-To-T-o--To--o--T---T----o-ooT--------o--------oooo-T-------oTo--------T---------o-------o--o-oTo--T-o---o--To---oT--o--------o-o-oT-oTT---T-----o-oo------f
--------|--T-----|--|-------TT------|-----|--|--|--T-|----T-|--TTT--T----|-------------T--------|--------|---------|------------------T----|---|--T-----|-----|----------T-----|--||---|------T--------f
m-----TT|--|E-ET-|--|E--T-E-||T-----|-E---|-E|--|--|-|-E--|-|E-|||-T|E--E|--E-T--E---TT|E----E-E|TEE-E-E-|--T--E---|E-----EE-T-E--E-E-|-E--|--E|E-|--E--|TT--E|E-E--E-T-E|E----|--||TEE|--T---|--E-----X
XXXXXXXXXXXXXXXXXXXXXXXXXXXXXXXXXXXXXXXXXXXXX|XXXXXXXXXXXXXXXXX|XXXXXXXXXXXXXXXXXXXXXXXXXXXXXXXXXXXXXXXXXXXXXXXXXXX|XXXXXXXXXXXXXXXXXX----XXXXXXXXXXXXXX|X|XXXXXXXXXXXXXXXXXXXXXXXXXXXXXXX----XXXXXXXXXX
