--------------------------------------------------------------------------------------------------------------------------------------------------------------------------------------------------------
--------------------------------------------------------------------------------------------------------------------------------------------------------------------------------------------------------
--------------------------------------------------------------------------------------------------------------------------------------------------------------------------------------------------------
--------------------------------------------------------------------------------------------------------------------------------------------------------------------------------------------------------
--------------------------------------------------------------------------------------------------------------------------------------------------------------------------------------------------------
--------------------------------------------------------------------------------------------------------------------------------------------------------------------------------------------------------
--------------------------------------------------------------------------------------------------------------------------------------------------------------------------------------------------------
---------------------------------------------------------------------------------------------------------------------------------------------------------------------------------------------------v----
--------------------------o-----------------------------------------------------------------------------------------------------------o---o--------------------------------------------------------f----
------------------------------------------------------------------------o--------------------------o------------------------------------------------o--------------------------------o-------------f----
-------------o------------------------------------------o------------------------------------------------------o-------------------------------M---------------------------------------------------f----
----------------B--------------------------------------------o--------------------------------------------------------------------TT--------------------------------------------------------------?f----
------------------------------------------------------B------------------------------------------------TT--o----------------------||----------------------M-------------o----------o---------------f----
----------------------M--------------------------------------------------------------------------------||--------M----------------||---------------------------------------------------------------f----
m----E--------------------------------------------------------------E----------------------------------||--E-------E--------------||-----------------------E--------------E------------------------X----
XXXXXXXXXXXXXXXXXXXXXXXXXXXXXXXXXXXXXXXXXXXXXXXXXXXXXXXXXXXXXXXXXXXXXXXXXXXXXXXXXXXXXXXXXXXXXXXXXXXXXXXXXXXXXXXXXXXXXXXXXXXXXXXXXXXXXXXXXXXXXXXXXXXXXXXXXXXXXXXXXXXXXXXXXXXXXXXXXXXXXXXXXXXXXXXXXXXXXXXX
