--------------------------------------------------------------------------------------------------------------------------------------------------------------------------------------------------------
--------------------------------------------------------------------------------------------------------------------------------------------------------------------------------------------------------
--------------------------------------------------------------------------------------------------------------------------------------------------------------------------------------------------------
--------------------------------------------------------------------------------------------------------------------------------------------------------------------------------------------------------
--------------------------------------------------------------------------------------------------------------------------------------------------------------------------------------------------------
--------------------------------------------------------------------------------------------------------------------------------------------------------------------------------------------------------
--------------------------------------------------------------------------------------------------------------------------------------------------------------------------------------------------------
---------------------------------------------------------------------------------------------------------------------------------------------------------------------------------------------------v----
---------------------------------------------------------------------------o---------------------------------------------------------------------------o-------------------------------------o-----f----
----------------------------------------------------------------------------------------------------------------------o----------------------------------------------------------------------------f----
----------------------------------o--------------------------------------------------------------------?-------------------------------------Mo-------------------o--------M----o------------------f----
----o-------------------------------------------------?--------M----------------------------------------------M-------------B------------------------------------------------------------------?---f----
--------------------o----------------------------------------------------------------------------------------------------------------------------------------o-------------------------------------f----
-----------------------------------------------------------------------------------------------------TT--------------------------------------------------------------------------------------------f----
m----E-------------------------E---------------------------------------------------------------------||---------------------------------E-----E----------------------------------------------------X----
XXXXXXXXXXXXXXXXXXXXXXXXXXXXXXXXXXXXXXXXXXXXXXXXXXXXXXXXXXXXXXXXXXXXXXXXXXXXXXXXXXXXXXXXXXXXXXXXXXXXXXXXXXXXXXXXXXXXXXXXXXXXXXXXXXXXXXXXXXXXXXXXXXXXXXXXXXXXXXXXXXXXXXXXXXXXXXXXXXXXXXXXXXXXXXXXXXXXXXXX
