--------------------------------------------------------------------------------------------------------------------------------------------------------------------------------------------------------
--------------------------------------------------------------------------------------------------------------------------------------------------------------------------------------------------------
--------------------------------------------------------------------------------------------------------------------------------------------------------------------------------------------------------
--------------------------------------------------------------------------------------------------------------------------------------------------------------------------------------------------------
--------------------------------------------------------------------------------------------------------------------------------------------------------------------------------------------------------
--------------------------------------------------------------------------------------------------------------------------------------------------------------------------------------------------------
--------------------------------------------------------------------------------------------------------------------------------------------------------------------------------------------------------
--------------------------------------------------------------------------------------------------------------------------------------------------------------------------------------------------------
--------------------------o--o-----------------oo-------o----o-----oo-------------o---o--o-----o-----------o-----o--oo-------o-------o--------------------------o-o--------------o-o----o-----o-o-------
-----------o--oB------MB--B----------o--o--Bo---oBB----Boo---o------B-B-?-Mo--?-o---o-----??---?----o?o-M---oB-oB---B------o-o---B--------B---------------?o--?o------o---?----B----o----Bo--o--B-------
--------B----------o---------M---o--M--------o----o-o----o---o-o-o-oo--?------M-------o--------B-------o----B-----?--o-----o--M----o----o-o---M----?M--o--M----o--Moo--oo-----oo---o-M-------oo---------
---------?--M-T---o--oo--?--o------o-------T-oo-----o?-o-To---o-M----o-----o-----o-o------M-o---o----------------o-----oM---M-----?-----o------M----MT?-oo------BB----o--T--------oo--------T-----------
-------------B|-o-----?--------B--ToBo-----|----?----B-B-|----o---M------?-o--------?---------B---o-v----B--M-Mo---TB-----T---o-o-T-o----?o--o--T--oo|o---T---?-o-?--o--o|o---B-M-----o--T-?|-----------
--------------|-T---------?-------|----M---|?-----T------|------------------------------------------f--B----M------|-T---M|--T----|----B-----M--|-?--|----|---M----------|B--------------|--|-----------
m-----------E-|-|-EE-E------E-----|-------E|------|------|-E---------------------------------E------f--E-----------|-|----|--|--E-|-EE---E------|----|----|--E---E-E-----|------E--------|--|-----------
XXXXXXXXXXXXXXXXXXXXXXXXXXXXXXXXXXXXXXXXXXXXXXXXXXXXXXXXXXXXXXXXXXXXXXXXXXXXXXXXXXXXXXXXXXXXXXXXXXXXXXXXXXXXXXXXXXXXXXXXXXXXXXXXXXXXXXXXXXXXXXXXXXXXXXXXXXXXXXXXXXXXXXXXXXXXXXXXXXXXXXXXXXXXXXXXXXXXXXXX
