--------------------------------------------------------------------------------------------------------------------------------------------------------------------------------------------------------
--------------------------------------------------------------------------------------------------------------------------------------------------------------------------------------------------------
--------------------------------------------------------------------------------------------------------------------------------------------------------------------------------------------------------
--------------------------------------------------------------------------------------------------------------------------------------------------------------------------------------------------------
--------------------------------------------------------------------------------------------------------------------------------------------------------------------------------------------------------
--------------------------------------------------------------------------------------------------------------------------------------------------------------------------------------------------------
--------------------------------------------------------------------------------------------------------------------------------------------------------------------------------------------------------
--------------------------------------------------------------------------------------------------------------------------------------------------------------------------------------------------------
-------------------------------------o---------o-------o-----------oo-----------o-o------o---o-o------------------------o--o-o-o---------------------o-oo----------------------oo--o---o-o---o----------
-------?---oB-oB------B-----------oB--------?-------B-------o-------B-B-o--o-??-o-B-o-----??-------oo?o-Mo-oM-----oo---B-o-o---?o-----o?---o------o?-------------?----M--M----oo-----oMBo----o-B-?------
--------B--------------------------------------o-o----o--B-----o-o-----------------o------------M-------?---o--M-o---------o--------------?--------------o--oB------o--oB-------o-B-----o--?o-----------
----------o-M-----o--o-o--o----T-o--------T--------?-o--o-----o-M-T--o---?-o-----o-o--------oo---B-----------B--?-o-o---oB-----MoTooMM-B------T--o--o--?--o-----------------M----o---TM--oo-------------
-------o-----B-BoM?------B-oo-o|----o-----|--TB--o-?---------o----|------?---------------o--o-B---o-v--oBT-?------o-o-oM---oo--B-|----o------o|T--------?--------B---T-o--M---------o|-----BT-----------
----------------T?------B-----?|-----M---T|--|-----M--------------|----B------?----------T----------f----|---------M------------T|-B-------B--||-B---T---------------|--------B------|---MMM|-----------
m----EE-----E---|-E--E--E-E----|---------||--|------------------E-|----------------------|----------f--E-|---E-------E---------E||---E--------||-----|-------E-----E-|----E----------|---E--|E----------
XXXXXXXXXXXXXXXXXXXXXXXXXXXXXXXXXXXXXXXXXXXXXXXXXXXXXXXXXXXXXXXXXXXXXXXXXXXXXXXXXXXXXXXXXXXXXXXXXXXXXXXXXXXXXXXXXXXXXXXXXXXXXXXXXXXXXXXXXXXXXXXXXXXXXXXXXXXXXXXXXXXXXXXXXXXXXXXXXXXXXXXXXXXXXXXXXXXXXXXX
