--------------------------------------------------------------------------------------------------------------------------------------------------------------------------------------------------------
--------------------------------------------------------------------------------------------------------------------------------------------------------------------------------------------------------
--------------------------------------------------------------------------------------------------------------------------------------------------------------------------------------------------------
--------------------------------------------------------------------------------------------------------------------------------------------------------------------------------------------------------
--------------------------------------------------------------------------------------------------------------------------------------------------------------------------------------------------------
--------------------------------------------------------------------------------------------------------------------------------------------------------------------------------------------------------
--------------------------------------------------------------------------------------------------------------------------------------------------------------------------------------------------------
-------------------------------------------------------------------------------------------------------------------------------------------------------------------------------------------------------v
--------o---ooo--------o------------------o-----------oo-o-------o------------oo-ooo--------------------------o------------------o-------------------o-o---o-------o-o----oo-----o----oo--o------------f
-----------o?oM-B-Bo?-M--o------o-oo?-----o-----?-----B----?-?-?-o-o?--?-B---o-----BoBB----?-o-M--o?o---o--o---B--o--------Boo----o---o?B-o-oo-----Boo-Bo-----o-o-o--o-----B------o-o---B-o?-MM-?------f
-------M-o----oo-?----------o-M---M-----?Moo-?--o----?-?--------o??--oBo---o-------M-------o-------M-M?-o-o-----M----o-----?-M----ooBo------o----Bo--o-o-----B-MMoM---------o---o------oMBoo---oo?-----f
------o-??o---Bo---o-o-o--M-------TT-M----?--MM----o--Mo---M-B-B--TTTT------o----o-----o-M-TTM-----B--BMo--o----o--Mo--ooB--?---o--------MMB?o----M-----MM?-o--------oo-oo--o-------M-B-----TT?MB------f
-------oMMBoMB--o-?----o---o--o--M||o-M--------------M----o--TT--TT|||M-o----?-o-M--o-TT-o-||o-M-o-----?-M--?-o---o---o--ooB----B---?---o-oo--?-------TT-------------o--?-o--o-o-o-TT-o--o--||M--------f
---------?--?M--B---B----?-------B||-?--B----?--MM-?M--------||--|||||----TT---?--M-?-||-MM||----?-------?-----M---M-------------TT-----?------T----B-||--?-----TT----------M------||-B---M-||--B------f
m-E--EE-----E-------E------E-EE--E||---E-----EE-E-----------E||E-|||||--E-||------E-EE||---||--E-----E------E------------------E-||-E-----E--E-|------||-----E--||EE-----E---------||----E--||-EE--E-E-X
XXXXXXXXXXXXXXXXXXXXXXXXXXXXXXXXXXXXXXXXXXXXXXXXXXXXXXXXXXXXXXXXXXXXXXXXXXXXXXXXXXXXXXXXXXXXXXXXXXXXXXXXXXXXXXXXXXXXXXXXXXXXXXXXXXXXXXXXXXXXXXXXXXXXXXXXXXXXXXXXXXXXXXXXXXXXXXXXXXXXXXXXXXXXXXXXXXXXXXXX
