--------------------------------------------------------------------------------------------------------------------------------------------------------------------------------------------------------
--------------------------------------------------------------------------------------------------------------------------------------------------------------------------------------------------------
--------------------------------------------------------------------------------------------------------------------------------------------------------------------------------------------------------
--------------------------------------------------------------------------------------------------------------------------------------------------------------------------------------------------------
--------------------------------------------------------------------------------------------------------------------------------------------------------------------------------------------------------
--------------------------------------------------------------------------------------------------------------------------------------------------------------------------------------------------------
--------------------------------------------------------------------------------------------------------------------------------------------------------------------------------------------------------
-------------------------------------------------------------------------------------------------------------------------------------------------------------------------------------------------------v
--------B-----------------------o------------------------------------------------?-BB---------o-------------------------------------------------X--B----------?B?B?-----------------------B------------f
-------------B------------------------------X-?----o---------?B?--BBB?B?-M-???B?--------------------------------------B?M---????-----------------------------------------------B?----------------------f
------o-------o--o---o-o-------------?B???B?---------MB?--M?----------o--------------------o----------------------------o---------------BB--?---------------------------------------X-------B-BB?------f
------------o--------------o--T------------------T-------T--------------o-o--M?BBB-?---------------X----------X----?-----------------------T--B-??--X---M-X--------X------T----------------------------f
-------------------B----------|----------?BB??---|-------|---------------o-------------------o---T-XX----MB--XX--------?--B?------BBBT--M?o|-o-----BXX--------------------|---X--------T---------------f
-------------T---T------------|---T--T-----------|-------|----------o-T--------------------------|-XXXo-----XXX------------o---------|-----|----o---XXX-------------------|------------|------o--------f
m--E---------|---|------------|--E|--|-----------|-------|-----E------|--------------------------|-XXXX----XXXX---------E-E----------|--XX-|--------XXXX------------------|------------|--------------XX
XXXXXXXXXXXXXXXXXXXXXXXXXXXXXXXXXXXXXXXXXXXXXXXXXXXXXXXXXXXXXXXXXXXXXXXXXXXXXXXXXXXXXXXXXXXXXXXXXXXXXXXXXXXXXXXXXXXXXXXXXXXXXXXXXXXXXXXXXXXXXXXXXXXXXXXXXXXXXXXXXXXXXXXXXXXXXXXXXXXXXXXXXXXXXXXXXXXXXXXX
