--------------------------------------------------------------------------------------------------------------------------------------------------------------------------------------------------------
--------------------------------------------------------------------------------------------------------------------------------------------------------------------------------------------------------
--------------------------------------------------------------------------------------------------------------------------------------------------------------------------------------------------------
--------------------------------------------------------------------------------------------------------------------------------------------------------------------------------------------------------
--------------------------------------------------------------------------------------------------------------------------------------------------------------------------------------------------------
--------------------------------------------------------------------------------------------------------------------------------------------------------------------------------------------------------
--------------------------------------------------------------------------------------------------------------------------------------------------------------------------------------------------------
-------------------------------------------------------------------------------------------------------------------------------------------------------------------------------------------------------v
------o-oo---o----oo---oo----o-----------o------------o-----oo----------o-------o-oo---------------------------------o-----------o--------------oo------o--oo-o-o--------o------------o----------------f
--------o-?o-BMoo----B-?----B-------BMB---o----M----Mo----B---o--?----B-B-----------oBB----oMo-M--o?----o------B-----------Boo-B--o---o?-o---M-----?o-------------B----o--B--o-B-M-------o---?-M-B-----f
------o-----M---o-----------B-?-B---o?------BM-M----------------o--B--oooo--------oM-------o-o-------M?-o-o-----M----o-----?------ooBo----MMM-o--M---o-?o-B------o-M--o?-?---------------?--o-M--------f
-------M-o-----M--?oo-o-?-o-o-----o-?---oBoo------oTT-----?--o----M-------oo---B--------oM-TT------B--BMoB-TT---o---o--o-B-M?-M-o---------o---oB---M--MM--MM--o--B--------o-?--o--------B-o--TToo------f
--------o---oB-?o?-M---TT--o-o--oTT---?-o--Bo-oBTT-||---BB-----oo-------?----TT--o----TT---||--?-------?-M-||-o----o--o---oB----B-------M---------?--TT-------o------o---M-o----o--Bo---TT---||oo------f
--------?BM----B--M----||----?---||-----------?-||-||---M--M---------M---TT--||---MM--||-M-||---------B-M--||------M-----------?------TT----M--B-----||---B--TT---------?---B---TT------TT---||B-------f
mEEE-E--E--E-E------E--||--------||--E----E--E-E||-||-------E------------||--||---E--E||---||--------------||--E---------------E--E---||E-E----------||E-E---||----E---E--E-----||--E---||--E||E---EEEEX
XXXXXXXXXXXXXXXXXXXXXXXXXXXXXXXXXXXXXXXXXXXXXXXXXXXXXXXXXXXXXXXXXXXXXXXXXXXXXXXXXXXXXXXXXXXXXXXXXXXXXXXXXXXXXXXXXXXXXXXXXXXXXXXXXXXXXXXXXXXXXXXXXXXXXXXXXXXXXXXXXXXXXXXXXXXXXXXXXXXXXXXXXXXXXXXXXXXXXXXX
