--------------------------------------------------------------------------------------------------------------------------------------------------------------------------------------------------------
--------------------------------------------------------------------------------------------------------------------------------------------------------------------------------------------------------
--------------------------------------------------------------------------------------------------------------------------------------------------------------------------------------------------------
--------------------------------------------------------------------------------------------------------------------------------------------------------------------------------------------------------
--------------------------------------------------------------------------------------------------------------------------------------------------------------------------------------------------------
--------------------------------------------------------------------------------------------------------------------------------------------------------------------------------------------------------
--------------------------------------------------------------------------------------------------------------------------------------------------------------------------------------------------------
-------------------------------------------------------------------------------------------------------------------------------------------------------------------------------------------------------v
------o---o--------o-o----o--o------o--o---oo--o--------o---o------o------o-------------------------o-oo-------------ooo--------oo------o---------o-o-------------o-----------o-o--------oo------------f
-----------Bo-M-M---?-B--o-Bo-o---?--?Boo-BoM--?oo?-------------oo--?o--oo?-o-o-------o?--B--Bo-----M?--o-M?-o-o----??---M--o-?----oM-?------o--B----M---oo--B--M?--o???-o--M-oB---?B----M---BB--------f
------B----o--o-B?--M-M--M-?o-B--?-o----oo-----M-oo-MooM--B----B---M-----??---B-o-o-------oooo------B--oo--?---------o--o---Bo--------Mo--M--?-o--B-o--?o?o?o--B--oo-----o?M-----?--o-----M------o-----f
------M-o-----MB----?--o--M-M-BB-oB---?M----M-o-?-?----To--B--B-Mo----M-o----o-MTT-----------o----o-----?B-oMo-TT---------o---??BMB-o--o----MTT-o-Bo-oo-M-o?-?o-----oMo--o-o-----oo------------o-------f
------TTTT-----B-----?T--o-----o-----M---M------------B|oM----M-o----o----o--M?-||-MM-?o-?-o--Mo-------B-o----o||---------o-T----o-o----M?-M-||--TTo---?----?---M---o-----oo-----------o---o-----?-----f
------||||--------M---|-M---M---B-----M-M-M------------|---M------M-B--------M--||T---------?B-B--------?------||?----------|-B--B-------M-?B||--||---?-----MBB----M--------B---M--T--?-----?-B-TT-----f
mEE---||||E---E-------|-E---E------E-EE----------------|E-E-----E-----E----E--E-|||---EE-E---E-----EE----------||--E-E-E----|-----------E----||--||E-------EEE------E--------E-----|EE-E-E--E-E-||----EX
XXXXXXXXXXXXXXXXXXXXXXXXXXXXXXXXXXXXXXXXXXXXXXXXXXXXXXXXXXXXXXXXXXXXXXXXXXXXXXXXXXXXXXXXXXXXXXXXXXXXXXXXXXXXXXXXXXXXXXXXXXXXXXXXXXXXXXXXXXXXXXXXXXXXXXXXXXXXXXXXXXXXXXXXXXXXXXXXXXXXXXXXXXXXXXXXXXXXXXXX
