--------------------------------------------------------------------------------------------------------------------------------------------------------------------------------------------------------
--------------------------------------------------------------------------------------------------------------------------------------------------------------------------------------------------------
--------------------------------------------------------------------------------------------------------------------------------------------------------------------------------------------------------
--------------------------------------------------------------------------------------------------------------------------------------------------------------------------------------------------------
--------------------------------------------------------------------------------------------------------------------------------------------------------------------------------------------------------
--------------------------------------------------------------------------------------------------------------------------------------------------------------------------------------------------------
--------------------------------------------------------------------------------------------------------------------------------------------------------------------------------------------------------
--------------------------------------------------------------------------------------------------------------------------------------------------------------------------------------------------------
-------o--o-o---o--------------o------o----------o--o-----o----------o-------------o-----o-o----o----------o-----------o-----o------------o-o----------o------o-------------------------o-------o-------
---------B-o--M-----?-------o-----?----B-??-M-------oo------MBo---o--?-o-?----o-o-o---------o-----M---?-------B----M---??-----B--B--------B?-----M-----?-M--oM-o----?------M?-o------o---?o-o-o---------
-------M---o--o------M------------?----o-oo--M------o--------o---oM---o?o--?-o--Bo--------M--B----o----o----M-o-o---o--M-o----B----------B-----------------o----oo------o----------o----MB-------B------
----------------o--------o--o------?o-?oM--?oo--M--o------T----------oT----o---o-o--B---o--M--o--o--o-To-----o-o-o--T---M-T---------------oo---o--oo-?----------M--oo----o---------o------o---T--o------
-----------M--o--?o-o----?--MM--T------o-B-----o----------|-o-----Bo-o|-------o-oo-o-Bo----oM-o?oo----|---B-o-oooBoo|-----|-----o------B------o-oT--Mov-o-o-oMM-?o--o---------T--B?-------o-o-|---------
----------?-----?-M-------------|--------------------M--M-|M-------?-T|---M-BT-B------T---M--------M--|--------?----|-----|-------B--------T-----|----f---M----------------T--|-----M-MB---?--|---------
m------E------------------------|------------E-----------E|----------||------|--------|---EE----------|-----------E-|-----|-------E------E-|-----|-E--f--------------------|--|---------E-----|-E--E----
XXXXXXXXXXXXXXXXXXXXXXXXXXXXXXXXXXXXXXXXXXXXXXXXXXXXXXXXXXXXXXXXXXXXXXXXXXXXXXXXXXXXXXXXXXXXXXXXXXXXXXXXXXXXXXXXXXXXXXXXXXXXXXXXXXXXXXXXXXXXXXXXXXXXXXXXXXXXXXXXXXXXXXXXXXXXXXXXXXXXXXXXXXXXXXXXXXXXXXXX
