--------------------------------------------------------------------------------------------------------------------------------------------------------------------------------------------------------
--------------------------------------------------------------------------------------------------------------------------------------------------------------------------------------------------------
--------------------------------------------------------------------------------------------------------------------------------------------------------------------------------------------------------
--------------------------------------------------------------------------------------------------------------------------------------------------------------------------------------------------------
--------------------------------------------------------------------------------------------------------------------------------------------------------------------------------------------------------
--------------------------------------------------------------------------------------------------------------------------------------------------------------------------------------------------------
--------------------------------------------------------------------------------------------------------------------------------------------------------------------------------------------------------
--------------------------------------------------------------------------------------------------------------------------------------------------------------------------------------------------------
------------o---------o-------o-o-o--------o-o-------------o--------------------------o----o----o---o---------------------------o------o--o--------------o----o--------------o--o----------o------------
---------?---o-?-------o--B------------?-?---------B----?o--------B--oo---------B--------------------o-?--o--o?--oM?--oo------M------?------o-?MM-------B--------M?--o------o-?--o-Bo--B--M--?----------
-------o---------oo---------------------oo---MB--------?------B---------o?-o---------M-----oMo?--o------------?------------------M-----M----B------B--------------oo--o--B----------v----o--o---o-------
--------B-o--------------Mo-------o--o------Too-------M-----B-----T----o-----T----------o--------?--M---T----------M--------M--o---oB-----o--------------o---Bo-------o----------o--f-o-----o----o------
-------oo-------?ooT--B-------M-oM-----oo---|--o----o--------o-B--|--o--o----|--?Bo----o--------o---?---|------o--o-o------oMBo----------M-B-------oo--o-oo---M---------------------f--o---?-----o------
-------------------|-----B----------------?-|-----------------B---|---B----?B|-B---------------M--------|----M-----------T---------M----M------T--?---T-----B------?------------?---f--------?----------
m--------------E---|------------------------|---E---E-----E-------|----------|--E-----------------------|----------------|---------------------|------|----E---E------E--------E----f---------E---------
XXXXXXXXXXXXXXXXXXXXXXXXXXXXXXXXXXXXXXXXXXXXXXXXXXXXXXXXXXXXXXXXXXXXXXXXXXXXXXXXXXXXXXXXXXXXXXXXXXXXXXXXXXXXXXXXXXXXXXXXXXXXXXXXXXXXXXXXXXXXXXXXXXXXXXXXXXXXXXXXXXXXXXXXXXXXXXXXXXXXXXXXXXXXXXXXXXXXXXXX
