--------------------------------------------------------------------------------------------------------------------------------------------------------------------------------------------------------
--------------------------------------------------------------------------------------------------------------------------------------------------------------------------------------------------------
--------------------------------------------------------------------------------------------------------------------------------------------------------------------------------------------------------
--------------------------------------------------------------------------------------------------------------------------------------------------------------------------------------------------------
--------------------------------------------------------------------------------------------------------------------------------------------------------------------------------------------------------
--------------------------------------------------------------------------------------------------------------------------------------------------------------------------------------------------------
--------------------------------------------------------------------------------------------------------------------------------------------------------------------------------------------------------
--------------------------------------------------------------------------------------------------------------------------------------------------------------------------------------------------------
-------o--------o-------o-------o-----o--------------------------o-------o-o----------o----------------o---o--o-----o-----o-----o-o---o---------o--o----o---------------o----o--o-------o-------o-------
---------B-o--M---------B--o---Bo------B-??-M--o-----B-o-oo---B-?----o--------?-o----?-----o----------oB----B----o--o-?--------o----o-o-Bo---o--oM-----B------?---M--B--o----o------B----?o-o-----------
-----------?--o--------o---o-----------o-oo--M-M--------o--?---o----?--?---MMo-------B-------?----------M----o-o------M-o----------------o-----o-------oBB-B---M----o-----?--o-----o----M--o----oB------
------------o---o--o-------------T-oo---M----o--o----B-----B-o---o-----o------o------oo-------o--BoB---M------o------------?---M-----?-T---o-T---------------o----B-o?M-----o----o--------o---T---------
---------------T-?--o----?-------|-----o-B--o----?---------------?--T--Bo----------o?o-----Mo-o--MMo-------------o----o-o---?TB--?--o--|-----|o--o-oMovo-----T----------o-o---o---?--o----o---|---------
----------?----|--B----T---------|-------------------M--------------|--M---B--------------------B------?---T---M?--M---------|---M-?---|-----TB----M--f------|-----------B----T-----M---------|---------
m---------E----|-------|--E----E-|-----------E-----EE-----E---------|-E-----E--------E----------------E----|-----------------|---------|-----|-----E--f------|E-----E-----E---|---------E-----|----E----
XXXXXXXXXXXXXXXXXXXXXXXXXXXXXXXXXXXXXXXXXXXXXXXXXXXXXXXXXXXXXXXXXXXXXXXXXXXXXXXXXXXXXXXXXXXXXXXXXXXXXXXXXXXXXXXXXXXXXXXXXXXXXXXXXXXXXXXXXXXXXXXXXXXXXXXXXXXXXXXXXXXXXXXXXXXXXXXXXXXXXXXXXXXXXXXXXXXXXXXX
