--------------------------------------------------------------------------------------------------------------------------------------------------------------------------------------------------------
--------------------------------------------------------------------------------------------------------------------------------------------------------------------------------------------------------
--------------------------------------------------------------------------------------------------------------------------------------------------------------------------------------------------------
--------------------------------------------------------------------------------------------------------------------------------------------------------------------------------------------------------
--------------------------------------------------------------------------------------------------------------------------------------------------------------------------------------------------------
--------------------------------------------------------------------------------------------------------------------------------------------------------------------------------------------------------
--------------------------------------------------------------------------------------------------------------------------------------------------------------------------------------------------------
-------------------------------------------------------------------------------------------------------------------------------------------------------------------------------------------------------v
-------o--------------o----ooo--o-------oo-o-o----o------------------o-o-o---o------o---o----o-o-------o-o---o-o---------o--o-o------oo-----o-o-ooo---oo--o-o-o--oo--o----o---o---o-o---oo--oo-o-o-----f
------?---o---o--BMoo-M-Bo---?-oo???oo-o---o?o---B-ooB-----o-B-o----B?-B-oo-o-B--BoM---M-M-B-o?--?M--o-o--?--o-?--oMM-Bo-o--B?-----B-MoBo?-?-M-oM--B--o?--o-----?--M--?ooMMo??Bo----?BMo----o---BM-----f
------ooo-o-oo---?-?--?--M--ooo-----Mo---?o--oB-o--B-----B-B-Boo--oo--o------oM----ooB-M-oM?----B----MoBo-M----oM--ooo-oo-oo-o?o--o--o---oMMoB--?oMMM---B--Mo---ooMo-o----M-o-M-o-o-?------?-o--B------f
-------oo--o-ooMT---M--o-oT----?o-----M?M--o------oT-oo-B--oT---o--MooB-o-o?--o-?---ooM---TB--o-?oMo?o----?-T-oo--o-oo-??-oBoBMB--oB-B?------Bo---M-----TMM-M-----M---oo-oo-M--ooooM------Mo--?-T------f
------o---B--ooT|--o-o-o--|To----oM-MB--M-M-B-oMoB-|-Bo-M-oMT-oo-----Mo-?-ooMo-o--M???----|----?-MBM-Bo-T--o|oo---oo-To--?-ToB-o-o----MM----oo-M-----o-o|oB-Mo-o---?---oB-oBMM--?oM------o?-Bo-o|------f
-------------?-||--M?-----||-----M--T?B----M-------|---TBM--|-----?-M?T-?---T-------T?---T|BB---MBTM--?-|--M|?-M-----|----T|-MB--?--M-----T-?M--TM------|-M--M---T----TMT-M------B----?--M------|M-----f
mEE-EE-E-E---EE||E--E----E||----E---|EE---EE---EE--|---|----|--EE----E|-E---|------E|-E--||-------|--E--|--E|--------|E---||---E---------E|--E--|-------|-------E|E--E|-|----E--------E---------|------X
XXXXXXXXXXXXXXXXXXXXXXXXXXXXXXXXXXXXXXXXXXXXXXXXXXXXXXXXXXXXXXXXXXXXXXXXXXXXXXXXXXXXXXXXXXXXXXXXXXXXXXXXXXXXXXXXXXXXXXXXXXXXXXXXXXXXXXXXXXXXXXXXXXXXXXXXXXXXXXXXXXXXXXXXXXXXXXXXXXXXXXXXXXXXXXXXXXXXXXXX
