--------------------------------------------------------------------------------------------------------------------------------------------------------------------------------------------------------
--------------------------------------------------------------------------------------------------------------------------------------------------------------------------------------------------------
--------------------------------------------------------------------------------------------------------------------------------------------------------------------------------------------------------
--------------------------------------------------------------------------------------------------------------------------------------------------------------------------------------------------------
--------------------------------------------------------------------------------------------------------------------------------------------------------------------------------------------------------
--------------------------------------------------------------------------------------------------------------------------------------------------------------------------------------------------------
--------------------------------------------------------------------------------------------------------------------------------------------------------------------------------------------------------
-------------------------------------------------------------------------------------------------------------------------------------------------------------------------------------------------------v
-------oo------------o-------------o---------------------o-------o------o-o---------o-----o---------o---------oo------------o-o---o-----o-------------------o----oo-----o---ooo------------------------f
------?-?-B-o-MMB---M-BMo---------M----?-----?--?---o-M---M---?--o--B-?-----M--o?------o--?------?----?Mo----?-----------Bo-------?--?-------B-o-?-??-o-----o--?--------B-o------o--o---M-?-----oB-----f
-------M-------M-o-o-oo-B----B-?o-o--o--B---M-o?-B-M-------------------B---?--?-------M-----oo---------o--o-?-----?------------?------------------o----?-----?o----?-?---M-B-----M-?--o----o--o--------f
-------B----To--o-?-o----------o-?-T------o---------?--o-----o---T-o----B-?---M--o-o--B---o-B----?-------B-o----B-----M------T-------T------?--oo----oMoo-----------oB--oo--oBo--B??----o--o-MBT-------f
------------|-oo----?---ooM--o-ooM-|---o-----o-?-M----o-B--------|--?--T------?---------o-B-o-M-------B--------------o---o---|o------|-M---?--oM---M-------oM----M--?M--o-o--T----M---T----M-o-|o------f
------M-B---|-----M---?------------|-------------------?---------|T----|---------------------------M---------------------B?--|---T--M|-M-----------------------B------?B-----|----B---T-----M-B|-------f
m---EE--E--E|--------------EE--E---|-----E------E----E-----------||----|---E------EE------E-----------E----------------------|---|---|--E----------------------E-E--E---E-E-E|--------|--EE-E--|-E-EE--X
XXXXXXXXXXXXXXXXXXXXXXXXXXXXXXXXXXXXXXXXXXXXXXXXXXXXXXXXXXXXXXXXXXXXXXXXXXXXXXXXXXXXXXXXXXXXXXXXXXXXXXXXXXXXXXXXXXXXXXXXXXXXXXXXXXXXXXXXXXXXXXXXXXXXXXXXXXXXXXXXXXXXXXXXXXXXXXXXXXXXXXXXXXXXXXXXXXXXXXXX
