--------------------------------------------------------------------------------------------------------------------------------------------------------------------------------------------------------
--------------------------------------------------------------------------------------------------------------------------------------------------------------------------------------------------------
--------------------------------------------------------------------------------------------------------------------------------------------------------------------------------------------------------
--------------------------------------------------------------------------------------------------------------------------------------------------------------------------------------------------------
--------------------------------------------------------------------------------------------------------------------------------------------------------------------------------------------------------
--------------------------------------------------------------------------------------------------------------------------------------------------------------------------------------------------------
--------------------------------------------------------------------------------------------------------------------------------------------------------------------------------------------------------
----------------------------------------------------------------------------------------------------------------------------------------------------------------------------------------------v---------
-------------oo---------------o----o---o----o-------------oo---------o--------o---o--------------o-------------------------o-----o-----------oo----------------o---o-----o------------------o-f---------
--------B--?------Mo-----o?-----?-----o--B---M-----------B-o--oB--o----?-------oo--?-------------o-B----?------------B-----M--?o---M--------BoB--------o--?-----o-?-----------??-----o------o-f---------
---------oB-------o--Bo?-oM---o-----------------o------------o--o---o-----M?---o---B-o------M--o--------------------M----o------------o-----o?---------B-o---oooo-oo-o---M-----o-B--o---------f--o------
--------o-----oB------o---------T-o---?-----T?-----o---T-------o--o---o------T--o-o------B---o-?o------o----------o-?--------------oo-------?------o------T-----M----B-Mo-o-----------To--?--of?--------
-------B------Mo-M-----------B--|--o------o-|---MoM--M-|--B---M--------------|---oo--T-------o---o---o---T--B-B----o---o----o-?-o----?--o-?-------?-------|--M--------T----?-o--o-?---|?------f---------
-------------M--?---?----------T|--T----B??-|--B---B---|-----M------?-----M--|-------|-------T--?--------|-----B-----?----------B---?----B-?----M------T--|-----------|--------------B|-M-----f---------
m---E---E----------------------||--|-------E|-------E--|-E-E-----------E-----|-------|--E----|-----------|-E---------------------E---------E----E------|--|-----------|------------EE-|-----E-X--E--E---
XXXXXXXXXXXXXXXXXXXXXXXXXXXXXXXXXXXXXXXXXXXXXXXXXXXXXXXXXXXXXXXXXXXXXXXXXXXXXXXXXXXXXXXXXXXXXXXXXXXXXXXXXXXXXXXXXXXXXXXXXXXXXXXXXXXXXXXXXXXXXXXXXXXXXXXXXXXXXXXXXXXXXXXXXXXXXXXXXXXXXXXXXXXXXXXXXXXXXXXX
