--------------------------------------------------------------------------------------------------------------------------------------------------------------------------------------------------------
--------------------------------------------------------------------------------------------------------------------------------------------------------------------------------------------------------
--------------------------------------------------------------------------------------------------------------------------------------------------------------------------------------------------------
--------------------------------------------------------------------------------------------------------------------------------------------------------------------------------------------------------
--------------------------------------------------------------------------------------------------------------------------------------------------------------------------------------------------------
--------------------------------------------------------------------------------------------------------------------------------------------------------------------------------------------------------
--------------------------------------------------------------------------------------------------------------------------------------------------------------------------------------------------------
-------------------------------------------------------------------------------------------------------------------------------------------------------------------------------------------------------v
-------o---------o----o------o------o-------o-------------------o--------o-------o--o---o--o--o----------oo-------o-oo-----o-----------o-----o----o--o-------------o-------o-----o--o------------------f
------------o--o?-B----o-B-----?o--oo--?----o---BM----o-?--o---o---B--oo--?----------o?-------B-o-Bo---BBoo---oB--?---B--Bo?--Boo--oBB------?-o-o-B--M-?--B-o-------o---o--o-?o-----M-----o---?-o------f
------B-----o--o-M---B---o--o----o----o--o---o---BM--?-?o-----o-----o---M?--o-M---o?------BM-o--Mo------------o--?oo---o---o-o----o---o-oM----oM-------------B--oo-M--o--o--oo----o---?-----M----------f
---------o-----o--o-o-o--?----T------o-?----?--B-------o-M-----?---o----oooo-o---M----oo--?-T--BB---o---?-B-----M-oo-----o---To-o--?---------?---M--?-M--o-o---M--M-------------M--To--o--------TB-----f
------To--ooB------------T--M-|-B----o---T----MoB-----------------o--------oBTooo----?--o?--|---T----?-?-----M----M---oo-----|--?---T----?---MB--?-?-----?--?-o--?--oB-?----------M|o---------o-|------f
------|B-----------T--T--|-M--|----BM----|------T--------M----------M--------|?-B------MBT--|---|--------T-----T---T-?-------|--M---|---M-M---M---------M-B---M--------------------|--M--B?B-??-|------f
m-EE--|EE-E-EE-E-E-|EE|-E|-E--|-----EE---|------|---------------------E--E---|----E------|--|E--|---EE-E-|-E-E-|E--|E-EEE-E--|-EE---|E------------------E-------EE-------E------E-E|-----EE-E---|-E--E-X
XXXXXXXXXXXXXXXXXXXXXXXXXXXXXXXXXXXXXXXXXXXXXXXXXXXXXXXXXXXXXXXXXXXXXXXXXXXXXXXXXXXXXXXXXXXXXXXXXXXXXXXXXXXXXXXXXXXXXXXXXXXXXXXXXXXXXXXXXXXXXXXXXXXXXXXXXXXXXXXXXXXXXXXXXXXXXXXXXXXXXXXXXXXXXXXXXXXXXXXX
