--------------------------------------------------------------------------------------------------------------------------------------------------------------------------------------------------------
--------------------------------------------------------------------------------------------------------------------------------------------------------------------------------------------------------
--------------------------------------------------------------------------------------------------------------------------------------------------------------------------------------------------------
--------------------------------------------------------------------------------------------------------------------------------------------------------------------------------------------------------
--------------------------------------------------------------------------------------------------------------------------------------------------------------------------------------------------------
--------------------------------------------------------------------------------------------------------------------------------------------------------------------------------------------------------
--------------------------------------------------------------------------------------------------------------------------------------------------------------------------------------------------------
----------------------------------------------------------------------------------------------------------------------------------------------------------------------------------------------v---------
---------o-o--------o-----------------------o----oo----o-o----o----------------------oo-o--o---oo-------o------o-o-o---o-----------o----o-----o-o------------o-o--o--o----o---o-------------o-f-o-------
-------?-----Bo-----?-----BM-o-o-o-------o-?-MB-----B---------------?o-o---------o---?--o?--o----M----Mo-B--------o-?-----B--o------------?--------?-------B-------o-o--o--BBoo-------B-----M-fo--------
-------B-o------------B-oM----o----?o----o------------?----?Bo-MBoo-------B---?--o-----o--M----o-----o---M-o-----o-oo-------------o---------o-o----M-----o----------------o----o--o--B--?-----fo-o------
-------o--o--M-------o-----o--o-?---o-----B-----Mo-M-----o-T-o-----M-o-----T-oo---T--M----o------B---?-----o-?-T--------------o?B--M--B-----o--------o-o-o-o---?----MB---o-o---M----o--o----BofM--------
--------M--B-o--MBoB--B------o--o---MM-oo-B----?----o------|-----o--MT-o-o-|---ooB|--------To-----T-------?--BT|-----------B----------T---------o---M---o-T--M-o?-?--oM?--T---M---------?---?of-o-------
-----------------MB?-------------M--T------T------M----TB--|---------|---M-|------|--------|-B----|-----------||-?-------T------?-----|----T-?-T----?-----|--------------M|--B--------T-------f---------
m-----------E----E-------------E----|---E--|-----------|---|---------|----E|------|E-------|------|-----------||---------|------------|----|---|--E----E--|-------------E-|-----------|-----E-X-EE------
XXXXXXXXXXXXXXXXXXXXXXXXXXXXXXXXXXXXXXXXXXXXXXXXXXXXXXXXXXXXXXXXXXXXXXXXXXXXXXXXXXXXXXXXXXXXXXXXXXXXXXXXXXXXXXXXXXXXXXXXXXXXXXXXXXXXXXXXXXXXXXXXXXXXXXXXXXXXXXXXXXXXXXXXXXXXXXXXXXXXXXXXXXXXXXXXXXXXXXXX
