--------------------------------------------------------------------------------------------------------------------------------------------------------------------------------------------------------
--------------------------------------------------------------------------------------------------------------------------------------------------------------------------------------------------------
--------------------------------------------------------------------------------------------------------------------------------------------------------------------------------------------------------
--------------------------------------------------------------------------------------------------------------------------------------------------------------------------------------------------------
--------------------------------------------------------------------------------------------------------------------------------------------------------------------------------------------------------
--------------------------------------------------------------------------------------------------------------------------------------------------------------------------------------------------------
--------------------------------------------------------------------------------------------------------------------------------------------------------------------------------------------------------
-------------------------------------------------------------------------------------------------------------------------------------------------------------------------------------------------------v
-----------oo-------o-o-----o-o--------------o-o---------o----o-oo-o--oo-----oo---------oo-----------o----o---ooo--o-----oo-------o---o---o-o-o------oo-o-o-----------------------o-----oo-o-----------f
--------o-Moo-oB-?-B-MBM------B--BBo---?------M--?-?-o---M--?---o-Bo--o--?o--?--o---M---------?o----o-B-oo---???--M---M-M-?--M-?---o--?------oMo------oB-------o-M-BB-o---M-B?M-?o-?---?-o--o--?-------f
-----------?oB-oooo-----?-M--M------M---B---------M--oo-------?----?B-----M-------BM?--o---B---o--oo--oo-oB--M-oooo-o--o?--?---B----??M--ooo---o---ooMMo-o------o----o--o--B-o---o----B-M?--oM---------f
------oB--M-----oo--o---o--------MMo-o--oT?--BTMo----Bo--T--T----o--o-o?B-M-----------o--o-M-Mo-B----o-------M-----o--B-?M----T-?----M---o---T----o--Mo-M---o--o--MoM-o-----o-B--MM--T?-B-?o--M--------f
------oB--o----B---oT-----B--oT-M--M----M|oo--|-?----B--M|-o|o----B-----------oo---oMo--T------M---T-T--M?-oMo-B?o-MBMB-o-----|BM?o----?-?M-o|-------BM-----Mo-?-Boo-oT-oo--M?-o-----|-----oo---M------f
--------------------|-------M-|----------|----|--T--B---B|--|M---M--B-?---B---?---B-----|--B---M?--|-|-B----M----------T---M--|---?--?-?-B?-?|-----?-M----BM?---------|---?-------M--|----M-----?------f
m-E----E--EEE-------|-EE------|E-E------E|----|E-|-E-E-E-|-E|--E-EE---E-E-------------EE|---------E|-|EE------------EE-|----E-|E-------E---E-|--EE-E----EE-----------E|E-E-EE--------|--E-E-E--E-------X
XXXXXXXXXXXXXXXXXXXXXXXXXXXXXXXXXXXXXXXXXXXXXXXXXXXXXXXXXXXXXXXXXXXXXXXXXXXXXXXXXXXXXXXXXXXXXXXXXXXXXXXXXXXXXXXXXXXXXXXXXXXXXXXXXXXXXXXXXXXXXXXXXXXXXXXXXXXXXXXXXXXXXXXXXXXXXXXXXXXXXXXXXXXXXXXXXXXXXXXX
