--------------------------------------------------------------------------------------------------------------------------------------------------------------------------------------------------------
--------------------------------------------------------------------------------------------------------------------------------------------------------------------------------------------------------
--------------------------------------------------------------------------------------------------------------------------------------------------------------------------------------------------------
--------------------------------------------------------------------------------------------------------------------------------------------------------------------------------------------------------
--------------------------------------------------------------------------------------------------------------------------------------------------------------------------------------------------------
--------------------------------------------------------------------------------------------------------------------------------------------------------------------------------------------------------
--------------------------------------------------------------------------------------------------------------------------------------------------------------------------------------------------------
-------------------------------------------------------------------------------------------------------------------------------------------------------------------------------------------------------v
------------o-------o-o--oo--o-o----------o-----o-o---o--oo-o-----oo----------o--oo-o--------o----o--o-----o--o--o-o--o-----------------o---oo-o--------oo-----o--o---oo------o---------o-oo-o--o------f
------?B------o----Bo-B-o--M?o-o?--o-Mo?---B-B--o--?--o--o-o?o---?--oMo-o--o-?--?-?oMoo?MBo-B-----o--?o-?------B-B-o---o?-o--oo-BM-o----Bo--B-o--o-B-o-B-Moo----ooBo-o-MoB?--??--o-----B-o--o-oMB------f
-------------o--oo--o--?o-M---?--?M?-MMo--B-M---ooM----oMo-o----o?---o-o?---M--Mo-------o--------o----o-oo-o-oBo-BB--?oBoM?MB--M?-M-oooo---M-B---o-M-oo-o--B--M---o?-M--o--o--o--M----B-B-------oo-----f
-------------BM?-o-o-?-?M--o---------oB----M-?--?--??oo?-?-?o-BM--?o-oo---o--o-?o?o-M------B----o--oM--?----o?--Booo-------o---o---oM-----o-M-o-Mo-oo?--ooo-MM-?-oB-----o-o-o--ooM-?-o-o------?oo------f
-------TB-o--T--MM---?o---B-o--oo-?-To-o-o-oo-o--M---oM----oo--M-TB-------oM--o-oB-o--ooo--To--Too?--B-o----o-M?-BM-?T----o??o----BT-o-MoBMo---ooo-oo--oT?MM--?----M---o?----oo--ooo--o-BT-M--oM-T-----f
------B|M-B--|--B----T-B-M-B---M----|M-?T?-T----?--M--------M--M-|-----M--M-M-----?M-M-M---|---|-M-B-?----B-------T--|-----T-B-----|?-M--?---------B-M--|-------?-M--------T--?-----M-?--|B---B--|-----f
mEE-E--|-E-E-|E-E----|EEEE----E-----|EE-|--|---E------ET-E-EE-E--|--E--EE----T--------E-E-T|E--|E------ET---------|-E|-E---|-E-----|E----T--E-E--------T|-------T--E--EE--E|-E-E--E----E-|-EE---E|E--EEX
XXXXXXXXXXXXXXXXXXXXXXXXXXXXXXXXXXXXXXXXXXXXXXXXXXXXXXXXXXXXXXXXXXXXXXXXXXXXXXXXXXXXXXXXXXX|XXXXXXXXXXXXXXXXXXXXXXXXXXXXXXXXXXXXXXXXXXXXXXXXXXXXXXXXXXXXXXXXXXXXXXXXXXXXXXXXXXXXXXXXXXXXX|XXXXXXXXXXXXXX
