--------------------------------------------------------------------------------------------------------------------------------------------------------------------------------------------------------
--------------------------------------------------------------------------------------------------------------------------------------------------------------------------------------------------------
--------------------------------------------------------------------------------------------------------------------------------------------------------------------------------------------------------
--------------------------------------------------------------------------------------------------------------------------------------------------------------------------------------------------------
--------------------------------------------------------------------------------------------------------------------------------------------------------------------------------------------------------
--------------------------------------------------------------------------------------------------------------------------------------------------------------------------------------------------------
--------------------------------------------------------------------------------------------------------------------------------------------------------------------------------------------------------
-------------------------------------------------------------------------------------------------------------------------------------------------------------------------------------------------------v
--------B-----------------------o?-----------------------------------------------B-BB---------o--------------------------------------------B----X--B----------???B?-----------------------B------------f
--------------------------------------------X-?----o---------?B?--?BBBB?-M-??BBB--------------------------------------B?M---?BB?-----------------------------------------------B?----------------------f
------o-------o--------o-------------BB???BB---------?BB--??-------------------------------o---------?----------------------------------B?--?-----------------------------?---------X-------M-BB?------f
---o-----------------------o--T------------------T-------T----------------o--M?BBB-?---------------X----------X----?-----------------------T--?-??--X---M-X--------X------T----------------------------f
-------------------B----------|----------BB???---|-------|---------------o-------------------o---T-XX----MB--XX--------BB-B?------BB?T--M?o|-o-----?XX--------------------|---X--------T---------------f
-------------T---T------------|---T--T-----------|-------|----------o-T--------------------------|-XXX------XXX----------------------|-----|----o---XXX-------------------|------------|---------------f
m------------|---|------------|--E|--|-----------|-------|------------|--------------------------|-XXXX----XXXX-----------E----------|E-XX-|--------XXXX----------E-------|------E-----|--------------XX
XXXXXXXXXXXXXXXXXXXXXXXXXXXXXXXXXXXXXXXXXXXXXXXXXXXXXXXXXXXXXXXXXXXXXXXXXXXXXXXXXXXXXXXXXXXXXXXXXXXXXXXXXXXXXXXXXXXXXXXXXXXXXXXXXXXXXXXXXXXXXXXXXXXXXXXXXXXXXXXXXXXXXXXXXXXXXXXXXXXXXXXXXXXXXXXXXXXXXXXX
