--------------------------------------------------------------------------------------------------------------------------------------------------------------------------------------------------------
--------------------------------------------------------------------------------------------------------------------------------------------------------------------------------------------------------
--------------------------------------------------------------------------------------------------------------------------------------------------------------------------------------------------------
--------------------------------------------------------------------------------------------------------------------------------------------------------------------------------------------------------
--------------------------------------------------------------------------------------------------------------------------------------------------------------------------------------------------------
--------------------------------------------------------------------------------------------------------------------------------------------------------------------------------------------------------
--------------------------------------------------------------------------------------------------------------------------------------------------------------------------------------------------------
--------------------------------------------------------------------------------------------------------------------------------------------------------------------------------------------------------
------------o-------------------o-o--o---------o---o------------------o-----o-o-----------o--o--------o------------------o----------oo-----o---------o-o---o---o----o------o--o-----------oo------------
---------?---o---ooo------B------------?------oo------B----o-?-B---o--?-------------o-Bo-o?-o--?-B-----o--------o-----?----o---o----oB--?--o-o-oo-B---?-oM-----------?-B----oo------o--B--M--?-o--------
-----------o------o-----o-----------------o---o---------o---------o------o-----o-B--o----MB---o------o---M---?B--o-M--o-?--M---o---M---o-----------M----------------?---M---------o-v-------------------
----------o----T----------o-----M?---o-----?----o---o-BT-----o-oo--M-----?o-o---o-o----o------M--o---o-MB--o----o----o---M---?-----T-------o--------o--o-------o----o---oo--------B-f-o----M--o--o------
--------o-----o|?o-T--B-------M-----T----o--o--oT------|--T-o---------o--------------T--o--------o-----oo----To-o---oo-------oo-o--|-----------?-o--------T------------oo---B---o---f----M--------------
---------------|---|----------------|--M?-------|------|--|---?-----------B-----?--M-|-?-------B-?-------BM--|---------------------|----------------------|-----B--?--------T------Tf-------------------
m-------------E|---|---------------E|----------E|------|--|------------------E------E|-----------------------|---------------------|-E---E----------------|---E-------------|-E----|f---------E---------
XXXXXXXXXXXXXXXXXXXXXXXXXXXXXXXXXXXXXXXXXXXXXXXXXXXXXXXXXXXXXXXXXXXXXXXXXXXXXXXXXXXXXXXXXXXXXXXXXXXXXXXXXXXXXXXXXXXXXXXXXXXXXXXXXXXXXXXXXXXXXXXXXXXXXXXXXXXXXXXXXXXXXXXXXXXXXXXXXXXXXXXXXXXXXXXXXXXXXXXX
