--------------------------------------------------------------------------------------------------------------------------------------------------------------------------------------------------------
--------------------------------------------------------------------------------------------------------------------------------------------------------------------------------------------------------
--------------------------------------------------------------------------------------------------------------------------------------------------------------------------------------------------------
--------------------------------------------------------------------------------------------------------------------------------------------------------------------------------------------------------
--------------------------------------------------------------------------------------------------------------------------------------------------------------------------------------------------------
--------------------------------------------------------------------------------------------------------------------------------------------------------------------------------------------------------
--------------------------------------------------------------------------------------------------------------------------------------------------------------------------------------------------------
--------------------------------------------------------------------------------------------------------------------------------------------------------------------------------------------------------
------------------o-----------o-----------o--o------------o---------------oo----o-----------------o---o-----o----------o-o----------------o-------o------o-o--o---oo--------------oo-o------o-----------
--------B----o--o-o--oB--B---?---o---o---?-------------o--o--?-----------??-o--o-----?-------??-------ooo-B?M-------B------o---o---o-----------o----B----------------M----M-?----B-----------?--o-------
------------o----o-o-B---o---------o-?-o---o--Bo-o-----?M--------o-?--oo--oo-o----------------o---B-----------o---M------o--oB------?--B---M----B---M------o--?---------------B----ov--------?o---------
-------Mo---------T--M--oo------M--oo--ooo-------B-o--o-----------BM--?o-?--o--------M--------o-o-------M--B-----o--o----T--------o-----B-oo---T---M--?o-o---MM------B---o-o------?-f-o-oB-M---M--------
--------M--?B-----|-------M----T----o----o------o-T-o-B-oB---BM-----oo--------------------------o----------o---oMo---M-o-|--oo--o-o-----T--BB--|----?-oo--------o---?----T-o------o-f-?---?----?-o------
--------?---------|------------|-?----------------|-?--------M-B----------------T?---T-B--T-?-----------------------M----|--------------|-----?|-------------?-----------|---MM-----f-------?----B------
m---E---------E-E-|------------|------E-----------|-------------E----------E----|----|----|-------E--------E---------E-EE|------E-------|------|--------E-----E----E---E-|-------E--f---------E---------
XXXXXXXXXXXXXXXXXXXXXXXXXXXXXXXXXXXXXXXXXXXXXXXXXXXXXXXXXXXXXXXXXXXXXXXXXXXXXXXXXXXXXXXXXXXXXXXXXXXXXXXXXXXXXXXXXXXXXXXXXXXXXXXXXXXXXXXXXXXXXXXXXXXXXXXXXXXXXXXXXXXXXXXXXXXXXXXXXXXXXXXXXXXXXXXXXXXXXXXX
