--------------------------------------------------------------------------------------------------------------------------------------------------------------------------------------------------------
--------------------------------------------------------------------------------------------------------------------------------------------------------------------------------------------------------
--------------------------------------------------------------------------------------------------------------------------------------------------------------------------------------------------------
--------------------------------------------------------------------------------------------------------------------------------------------------------------------------------------------------------
--------------------------------------------------------------------------------------------------------------------------------------------------------------------------------------------------------
--------------------------------------------------------------------------------------------------------------------------------------------------------------------------------------------------------
--------------------------------------------------------------------------------------------------------------------------------------------------------------------------------------------------------
--------------------------------------------------------------------------------------------------------------------------------------------------------------------------------------------------------
--------o---------------------------------------o------------------o---o------------------o--------o-o-----------o--o---o----------------o--o---------o-----o-----ooo----------o----------o-o-----------
--------------oMB-------B-?o-?--o-?---o--ooM-oo----?-o-------------BM--o-------B-o--?-?----------o----B-MBo-B-o--B-B------M---o-?------?-----oM----ooB------o---o-o----?---o-o--o--o-------?o-B--?------
---------?---------o---o--------------oo--B-----o----oo--o?B---------?---o----o-?-------oo-o----o--oo-------o------B-----------o-o------o-o-o-oo---o-Boo---o?o-M-o------------oMoB-?-----?-B------------
-----------o--o-o---oo-o-oM---o-----B-o----o-o---?o---B---o------o----o---oo--o--o----------Boo-To--M--o-------o--B-T---o----?--o-----o--------o--oT----o-B-o----------o--ooM---o---------B--oo---------
v--------Bo?--M---o-----T-------o----o---Booo------o--o-T--M--o-?oo---T-----------o--M------o---|--------------o----|---B---------Bo-M-----T-o--M--|?--BM--M---ooo--B----o-B--B--?T----o-MBTo--o--------
f--------------M--B---T-|M--B-----BM--T--M----T----MM---|------M------|----------------B--------|--------?----------|----------------------|-------|-----------M-------B---?------|--------|-M----------
f-------E-E----------E|-|-----E-------|-------|-----E---|-------------|------------------E------|-E-----------------|------------E---E----E|------E|------E-----------E-----------|------E-|--------E---
fXXXXXXXXXXXXXXXXXXXXXXXXXXXXXXXXXXXXXXXXXXXXXXXXXXXXXXXXXXXXXXXXXXXXXXXXXXXXXXXXXXXXXXXXXXXXXXXXXXXXXXXXXXXXXXXXXXXXXXXXXXXXXXXXXXXXXXXXXXXXXXXXXXXXXXXXXXXXXXXXXXXXXXXXXXXXXXXXXXXXXXXXXXXXXXXXXXXXXXX
