--------------------------------------------------------------------------------------------------------------------------------------------------------------------------------------------------------
--------------------------------------------------------------------------------------------------------------------------------------------------------------------------------------------------------
--------------------------------------------------------------------------------------------------------------------------------------------------------------------------------------------------------
--------------------------------------------------------------------------------------------------------------------------------------------------------------------------------------------------------
--------------------------------------------------------------------------------------------------------------------------------------------------------------------------------------------------------
--------------------------------------------------------------------------------------------------------------------------------------------------------------------------------------------------------
--------------------------------------------------------------------------------------------------------------------------------------------------------------------------------------------------------
-------------------------------------------------------------------------------------------------------------------------------------------------------------------------------------------------------v
-------o----o----------o-------oo-oo------o-----------------------o--------------o------ooo---o-----o-oo------o-------oo--------------o---------o---------------------------oo--o---o--o----o---o------f
----------?B---?o?-o-o--o---ooo---------o-?---M---?-------o--B-----------?----------oB-B--o-o-o-----M?--ooM----o----??---Mo-----?o---oB---ooo-oM-?----------B-o-o---M--B---o--?o----oM?----?----o------f
-----------?-Mo-Moo-BB?MM---o-?--?-Bo?oo-o--------M-o-o--o-----------o?-----o-----BB-o-o---ooo-Mo------oo?-?---------o--o--B-----o-------B------MoM-----M--o----MoM-?---B-?--o-B---------?o---?--------f
--------?----M---o----M--BBo?--TT--------?o-----o-----TT-------M---o------------BM-o-o-o----ooB-M-o-----?B-oMo-TT---------o-oTT-------?o-ooo---M-oo-?--o------o------o--B-----?o----ToB---o--TT--------f
-------B------oB--oo---oo-o----||-----o------o?B-ooM?-||---o--B----M--o--o---------?-?-------M---------B-o----o||---o-----o-?||---o?---?---??------o--B------oM-o---------oo--------|----MBoo||BB------f
-------TTT----?-BM---?-M-------||-----B-M----B--?B--M-||-----?-?--------------------B----M--------------?------||?-----------||------------TTM?--------M--M--M-B------M-----B-------|?B----M-||--M-----f
mEEE-EE|||----EE--E-------E---E||E------------E--EE---||-EE-E---E-------EE--------------------E-----E------E---||--E-E-------||------E-----||E-----EE------------E---------------EE-|E---E-E-||E-E-EE--X
XXXXXXXXXXXXXXXXXXXXXXXXXXXXXXXXXXXXXXXXXXXXXXXXXXXXXXXXXXXXXXXXXXXXXXXXXXXXXXXXXXXXXXXXXXXXXXXXXXXXXXXXXXXXXXXXXXXXXXXXXXXXXXXXXXXXXXXXXXXXXXXXXXXXXXXXXXXXXXXXXXXXXXXXXXXXXXXXXXXXXXXXXXXXXXXXXXXXXXXX
