--------------------------------------------------------------------------------------------------------------------------------------------------------------------------------------------------------
--------------------------------------------------------------------------------------------------------------------------------------------------------------------------------------------------------
--------------------------------------------------------------------------------------------------------------------------------------------------------------------------------------------------------
--------------------------------------------------------------------------------------------------------------------------------------------------------------------------------------------------------
--------------------------------------------------------------------------------------------------------------------------------------------------------------------------------------------------------
--------------------------------------------------------------------------------------------------------------------------------------------------------------------------------------------------------
--------------------------------------------------------------------------------------------------------------------------------------------------------------------------------------------------------
---------------------------------------------------------------------------------------------------------------------------------------------------------------------------------------------------v----
---------------------------------------------o---------------------------------------------------------------------o----------------------o-------o------o-----------------------------------------f----
-------------o------------------------------------------------------------------------------o---o--------------------------------------------------------------------------------------------------f----
--------------------------------------------------o-----------------------------------------------------o---------o--------------------------------------------------------------------------------f----
----M---------------------------------------------------o------------------------------------?------o------o--------------------------------------------------------------o----------M------------Bf----
---------M------------------------------------------------------------B-TT---------------------------------------o------------------M-----------------B---------------B----------------------------f----
----------------------M----------------------------------------TT-------||-------------------------------TT-M--------------------------------------------------------------------------------------f----
m-------------E-------------------------------------------E----||-------||---------E------------E--------||----------------E--------------------------------E--------------------------------------X----
XXXXXXXXXXXXXXXXXXXXXXXXXXXXXXXXXXXXXXXXXXXXXXXXXXXXXXXXXXXXXXXXXXXXXXXXXXXXXXXXXXXXXXXXXXXXXXXXXXXXXXXXXXXXXXXXXXXXXXXXXXXXXXXXXXXXXXXXXXXXXXXXXXXXXXXXXXXXXXXXXXXXXXXXXXXXXXXXXXXXXXXXXXXXXXXXXXXXXXXX
