--------------------------------------------------------------------------------------------------------------------------------------------------------------------------------------------------------
--------------------------------------------------------------------------------------------------------------------------------------------------------------------------------------------------------
--------------------------------------------------------------------------------------------------------------------------------------------------------------------------------------------------------
--------------------------------------------------------------------------------------------------------------------------------------------------------------------------------------------------------
--------------------------------------------------------------------------------------------------------------------------------------------------------------------------------------------------------
--------------------------------------------------------------------------------------------------------------------------------------------------------------------------------------------------------
--------------------------------------------------------------------------------------------------------------------------------------------------------------------------------------------------------
-------------------------------------------------------------------------------------------------------------------------------------------------------------------------------------------------------v
--------ooo--------oooo---------o--o----o-o-o------oo-----o-----o----o---------oo--o--oo----------o------o--oo---------o---o-o--o------o-o-------o-oo-oo--------o----o--oo-----o-o----oo-o------oo-----f
-----------------oo--------o-o---o-oo---ooo-----o------o-----------ooooo-----o----o--o-----oo--o----------o--o-o-------oo---------o-----o----o-------------o-o--o--------oo-------o------o-------------f
------oo-o---o---o----o----oo----o---------oo---o-------o------------------------o-oo-o-o--o---o---ooo-o--------o--o-----oo----------------o-o----------oo-------------o-o-----o-----------------------f
------oo---o------------o----------ooo-----o--oo--o--o-o-oo-o-ooo---o--------o---o---o-----------o---o------o------o---o-----------o-o---------------o--oo--------oo-o------------oo-----o-ooo---------f
-------o---Too--o---T--o------To-o-oTT------To--o------o-----------ToToo-TT---o--T-T--T-T-----T-oT-oo-o--TT-o-------To---T---o-o--T-o--------T-T---T------------o----oTo--------oo--o--oTo---T-o-------f
------T-T--|--------|---T-T---|-----||------|-TT----------T--------|-|---||-T----T-|--|-|T----|--|-------||---------|----|----T---|T--T----T-|-T--T|---------------T--|----------------T|----|---------f
m-----|-T--|E-TTE-E-|-E-|E|EE-|-----||-E----|-||------E-EE|-E-E---E|-|EEE||-|-E--|E|-T|-|TE---|--|--ET---||-----T---|-EE-|--EE|E-T||--|T--T|-|-|-T||-E----E----T---|--|EE--E------T----||----|ETEE-----X
XXXXXXXXXXXXXXXXXXXXXXXXXXXXXXXXXXXXXXXXXXXXXXXXXXXXXXXXXXXXXXXXXXXXXXXXXXXXXX----X|XXXXXXXXXXXXXXXXXXXXXXXXXXXXXXXXXXXXXXXXXXXXX---XXX---XXXXXXXXXXXXXXXXXXXXXXXXXXXXXXXXXXXXXXXXXXXXXXXXXXXXXXXXXXXXXX
