--------------------------------------------------------------------------------------------------------------------------------------------------------------------------------------------------------
--------------------------------------------------------------------------------------------------------------------------------------------------------------------------------------------------------
--------------------------------------------------------------------------------------------------------------------------------------------------------------------------------------------------------
--------------------------------------------------------------------------------------------------------------------------------------------------------------------------------------------------------
--------------------------------------------------------------------------------------------------------------------------------------------------------------------------------------------------------
--------------------------------------------------------------------------------------------------------------------------------------------------------------------------------------------------------
--------------------------------------------------------------------------------------------------------------------------------------------------------------------------------------------------------
--------------------------------------------------------------------------------------------------------------------------------------------------------------------------------------------------------
--------------------oo--oo--------o--------------o-----------o-o--o-oo--------oo-------------o--o-------o----------------o--oo------o----------o------o-o-------------------oo-o-o----o-o---------------
-------o-----M?o--o---B----?-M-----?-o--oo---?B-o---o?----o-oo----o?o-o?-----?o-------??Mo-----B--o-----B-o---?---o--ooB-B--------oM-?---o---o-o---oB----o--o-----o-------B------?o-o------B-o?--o------
--------M--?-o-----------o--B-oo-------o--M-------o---BM-M----o---o---------o---o--o----o----M--------o---------?--o----o--o-------------oB--Mo-----------o-?-o---B----------------?--?--o----B-o-------
--------Mo----oo---o-M----------o-----M--o--o---oo------oM?------M------?-o-M---o---o-B----o---o-M--o---ooo-B-------oo----?--B-M-----MM-oo--o------------M--B-o--B------o---------?---T-------?-B-------
-------B----oB-TT-----?----------Mo-B----------oo----M?---To---MBT------------M-Bo-----------?-----o-o----?-T---o----o---o-o----T--T-M-o--T---------o-v---o---------?-----o--TM--Bo---|--o--------------
---------------||?----------------B----?---?--------------|------|--------B----------------------B---T------|--M---?------------|--|-B---B|-----------f-M-MT-----------------|--------|-----------------
m--------EE----||------------------E-E-E-E----------------|--E--E|E--------------------------E-------|----E-|---EEE---E---------|--|E----E|-----------f----|-----------------|-------E|-EE--E-E---------
XXXXXXXXXXXXXXXXXXXXXXXXXXXXXXXXXXXXXXXXXXXXXXXXXXXXXXXXXXXXXXXXXXXXXXXXXXXXXXXXXXXXXXXXXXXXXXXXXXXXXXXXXXXXXXXXXXXXXXXXXXXXXXXXXXXXXXXXXXXXXXXXXXXXXXXXXXXXXXXXXXXXXXXXXXXXXXXXXXXXXXXXXXXXXXXXXXXXXXXX
