--------------------------------------------------------------------------------------------------------------------------------------------------------------------------------------------------------
--------------------------------------------------------------------------------------------------------------------------------------------------------------------------------------------------------
--------------------------------------------------------------------------------------------------------------------------------------------------------------------------------------------------------
--------------------------------------------------------------------------------------------------------------------------------------------------------------------------------------------------------
--------------------------------------------------------------------------------------------------------------------------------------------------------------------------------------------------------
--------------------------------------------------------------------------------------------------------------------------------------------------------------------------------------------------------
--------------------------------------------------------------------------------------------------------------------------------------------------------------------------------------------------------
-------------------------------------------------------------------------------------------------------------------------------------------------------------------------------------------------------v
------o-o----------oo------o--o---o--o---ooo---o-------o---------------o-----o---o-------o----oo---------o-o--o--o----------oo------o--o-o-------o--o-o----------o----o----o-------------o---oo--------f
-------o--o----o---?----o--B----oB-?--B-o---o-----BM-o?B--------------?---o----?B---o--------B--o--B-o--oo-?---oo-----?-----?--M-M---BBB-B----?-o-o-?-B-?oM-o-o---M-?----oB-?-----Moo--?---?o---M------f
---------o-M---M-Bo---?------Bo---o---o-----Mo?---o------Moo-oB--o------?-------------?---o---M-----o--?--?-B----------o------Bo---o----B-M----o-Bo------o--o---o-------Bo-?-Mo--oM-o---o-------o------f
------?B--o-T-To----T----M--MB-----oT-o---?-----------------oooo--M--?---o-T-B-----Bo--T---o---?M---o---o-----o------M-T-Mooo--Bo--o-----o---------T--o--oM---o------M---Bo--o---o-M--?--T-------------f
-----------o|-|-?-o-|---Mo----?-B--o|B?--M-M-BToMBB-------o--?--o-oB-------|-oM?-------T-o--B---T---B-----------o------|Moo-o------oo-?--o---o-oBo-|B---M--T----M----o------o?--T-oo-o---|o-M----------f
--------TM--|M|-----|----M----------|-----MM-?|---------------BMB----------|M----B?--M-|--------|----?T--B-------------|M-?--------------T--B--M--M|-?-MM--|-------?------B---T-|M------M|---B?-B------f
m-E-E-E-|E--|-|-EEE-|-E---E---E----E|----E----|------E---E-----------E---E-|-----------|----EEE-|-----|---E----E--E-EE-|------EE---------|E-E------|-EE----|--E-----E--E-E----|-|--EE----|E--E-----E--EX
XXXXXXXXXXXXXXXXXXXXXXXXXXXXXXXXXXXXXXXXXXXXXXXXXXXXXXXXXXXXXXXXXXXXXXXXXXXXXXXXXXXXXXXXXXXXXXXXXXXXXXXXXXXXXXXXXXXXXXXXXXXXXXXXXXXXXXXXXXXXXXXXXXXXXXXXXXXXXXXXXXXXXXXXXXXXXXXXXXXXXXXXXXXXXXXXXXXXXXXX
