--------------------------------------------------------------------------------------------------------------------------------------------------------------------------------------------------------
--------------------------------------------------------------------------------------------------------------------------------------------------------------------------------------------------------
--------------------------------------------------------------------------------------------------------------------------------------------------------------------------------------------------------
--------------------------------------------------------------------------------------------------------------------------------------------------------------------------------------------------------
--------------------------------------------------------------------------------------------------------------------------------------------------------------------------------------------------------
--------------------------------------------------------------------------------------------------------------------------------------------------------------------------------------------------------
--------------------------------------------------------------------------------------------------------------------------------------------------------------------------------------------------------
--------------------------------------------------------------------------------------------------------------------------------------------------------------------------------------------------------
-------o----o---o------o----o--o----------------------o-----------o-o--------------o-----o------o----------------------o--------------o---o-o------ooo-o-----oo------o----o---------------o-----o-------
---------B-o--M-----?o---o-----?o--------B------MB--------------?----Bo----B--o-o-o---------o-----M-o-?-------B----M----?-----B--B-----?---?-----MM----?-M-o-------o?o--B---o-M--o-M---o-?o-o----o------
-------M-----Bo----o---------o------------oo----B-------?---o--o--B-------------Bo--------M--B----o----o----Mo-----------o----B------o---B--oo-------------o-o-o--oB--M-M----?------o------------B------
----------------o-o---oM-----M---o----o--o--o----oo---?----T--?----o-o-BoT-----o-o------o--M--o--o--o-To-----oBo-o--T-o-M-----------------oo---o---o-?----------o--T--o?--o---oo---o----?-o---T---------
-----------M?-??-?--o-o----B--B---o---o------o-o------M---o|---?-----BMoo|----o-oo---B-----T--o?oo----|---B-o-oo-Boo|-----------o------B------o--T--Mov-o-o-o-T---M|----oo-------o-o--B---oo--|---------
--------B-?-------------T-----?----T-----------------------|-------------|-----B------T---M|-------M-B|--------?----|-M-----------B--------------T----f-------|----|?------?-----M------------|M--------
m------E--------------E-|-------E--|--E-------------E------|-------------|------------|---E|----------|-------------|---------E---E------E-------|-E--f-------|---E|--EE----------------------|-E--E----
XXXXXXXXXXXXXXXXXXXXXXXXXXXXXXXXXXXXXXXXXXXXXXXXXXXXXXXXXXXXXXXXXXXXXXXXXXXXXXXXXXXXXXXXXXXXXXXXXXXXXXXXXXXXXXXXXXXXXXXXXXXXXXXXXXXXXXXXXXXXXXXXXXXXXXXXXXXXXXXXXXXXXXXXXXXXXXXXXXXXXXXXXXXXXXXXXXXXXXXX
