--------------------------------------------------------------------------------------------------------------------------------------------------------------------------------------------------------
--------------------------------------------------------------------------------------------------------------------------------------------------------------------------------------------------------
--------------------------------------------------------------------------------------------------------------------------------------------------------------------------------------------------------
--------------------------------------------------------------------------------------------------------------------------------------------------------------------------------------------------------
--------------------------------------------------------------------------------------------------------------------------------------------------------------------------------------------------------
--------------------------------------------------------------------------------------------------------------------------------------------------------------------------------------------------------
--------------------------------------------------------------------------------------------------------------------------------------------------------------------------------------------------------
--------------------------------------------------------------------------------------------------------------------------------------------------------------------------------------------------------
-------------------oo---o-----o-o----------o----------oo-o---o--o--o---------------------------------o-------------o-----------------o--------------------o-o----o--------o----------------o------------
---------o-o-?-B----o-o--B----o------oB----------o-o?--MB--Mo--?--o--o---B---oB--------M---------o-------------?---o--o-------M--?o---o-?--o-o?-o--o---o--?----M-M------?----M----B------B-----B--------
-------?--o--o---B---o------oM--o--o--oo----o---o------------o-----------o-oB----M---?------o-o-M-o--o--B-------------o--BB--o------------------------------------?-----?o---o--o--------------o--------
--------M-----o--o-------M----T-MoM------------oB--oB---------M-o------T----o-o-?-------?-T------oo-M---o-M--oo-o--o----T----------B-------?oM-----o-o-?-----o----------o-----M---T-?------MT?-B-o------
v------o--o----BTo---o--------|---Mo------?---o---T-o---B--T---o-oM---o|----?--B---T------|-B--o--?--M------o---?-o-oT--|--------B--o--------------o---T-?---?----o-M-----M----o--|----o--o-|-----------
f---------------|-----M------M|------------T??-T--|-------T|--------TB-|--M--?-----|------|---MM--T------------M-B---|--|-----?-B----M------------T--B-|-------T-B--------------B-|---?B-M--|-----------
f-------E--E----|------E------|------------|---|--|-------||------E-|--|--------E--|--E---|-------|E----------E------|--|----------EE--E----------|----|-------|----E----------E--|-----E---|---E--E----
fXXXXXXXXXXXXXXXXXXXXXXXXXXXXXXXXXXXXXXXXXXXXXXXXXXXXXXXXXXXXXXXXXXXXXXXXXXXXXXXXXXXXXXXXXXXXXXXXXXXXXXXXXXXXXXXXXXXXXXXXXXXXXXXXXXXXXXXXXXXXXXXXXXXXXXXXXXXXXXXXXXXXXXXXXXXXXXXXXXXXXXXXXXXXXXXXXXXXXXX
