--------------------------------------------------------------------------------------------------------------------------------------------------------------------------------------------------------
--------------------------------------------------------------------------------------------------------------------------------------------------------------------------------------------------------
--------------------------------------------------------------------------------------------------------------------------------------------------------------------------------------------------------
--------------------------------------------------------------------------------------------------------------------------------------------------------------------------------------------------------
--------------------------------------------------------------------------------------------------------------------------------------------------------------------------------------------------------
--------------------------------------------------------------------------------------------------------------------------------------------------------------------------------------------------------
--------------------------------------------------------------------------------------------------------------------------------------------------------------------------------------------------------
--------------------------------------------------------------------------------------------------------------------------------------------------------------------------------------------------------
-----------------------------------oooo-----o---o------o------o---o------o----------------ooo-o---------o--------------------o--o----o---oo-----------------oo------------o---ooo-------o----oo---------
--------o---B-------o--?o-M---M?M---------o-B------------o---B---ooo-------B-------?----o-------?B-----B---o----?-----------oo--?o--B-M---Bo--?-----------?---------B------o-o---o?---o-B---------------
------------Bo-------oo?---o-?---?-Moo--o----o-o--o-o----M----------?-o-o--o-?------Bo--oo-?-o-------o--Boo-o--Bo-----------o---?--------o-?-?-------B----M----Mo----o--o-oM-M-M-o-o-o---M--------------
---------B-M---T--o---o-------o-------MT---o---o--------B---T--M-----M--B-B---oT---T-------M-----M-o--------oB--T----o----------MM---o-o--------------?--M------------o---BM-------o--?--oB-------------
--------?------|Bo---------T--ooMoo----|---B-------?-TM-?B--|-----o--o---------|o--|M-o------------oo-----------|------?-TT-Bo--B-o--oB-Bo-o--------o-vo?--oT---------T?--------------------oTo-?-------
-------------M-|-?---------|-----------|----------T--|-B----|----------BT------|-?-|-?-------------------M------|--------||-B--------T--B---?-----BB--f-----|---B-----|----------------MBB---|----------
m-------E----E-|-E---------|-------E---|---------E|--|--E---|E-----E-E--|------|---|-----------E-------------E--|--------||----------|E----E----------f--E--|---------|------------E------E--|-----E----
XXXXXXXXXXXXXXXXXXXXXXXXXXXXXXXXXXXXXXXXXXXXXXXXXXXXXXXXXXXXXXXXXXXXXXXXXXXXXXXXXXXXXXXXXXXXXXXXXXXXXXXXXXXXXXXXXXXXXXXXXXXXXXXXXXXXXXXXXXXXXXXXXXXXXXXXXXXXXXXXXXXXXXXXXXXXXXXXXXXXXXXXXXXXXXXXXXXXXXXX
