--------------------------------------------------------------------------------------------------------------------------------------------------------------------------------------------------------
--------------------------------------------------------------------------------------------------------------------------------------------------------------------------------------------------------
--------------------------------------------------------------------------------------------------------------------------------------------------------------------------------------------------------
--------------------------------------------------------------------------------------------------------------------------------------------------------------------------------------------------------
--------------------------------------------------------------------------------------------------------------------------------------------------------------------------------------------------------
--------------------------------------------------------------------------------------------------------------------------------------------------------------------------------------------------------
--------------------------------------------------------------------------------------------------------------------------------------------------------------------------------------------------------
--------------------------------------------------------------------------------------------------------------------------------------------------------------------------------------------------------
-------o---o----o-------o-------o-----o-oo------------o-------------o-----o-------------oo------o-----------o-----o-o----o-------------------------o------o-------o--o-o--------------o-o----o--o-------
-------o-B-o-?M---o-o---Bo-oo-o--------B?--------?o-----?-------?--o-B-----B--------------?-M----MM-------------------?M--B----------?o--B-o----o----B--------B--o-o-o---B--?-------M-o--?o-o----o------
--------------o---?----o-----o--o---?--o-----o----------?---o--o-----------------o-?--o---Mo-------------B----o---o-----o-------oo?--MMM-o---?o-o---Bo--o---?----------?-o-??------o-o--M--------B------
----------------o--------T-------T-Mo---M--T------ooo---------?---------oT--------B-M---------M-----o-o-M---?-----------------o-------------o-------o------o----o-o-T---T-------M-----o---o--MT---------
------------M--o-?--oB?--|--T--?-|-----o---|BB------o-----------------M-o|---B-----o--o--oo---B----o-o--T-----o----B---o----o-o--?-o-oo-------o---o---v------?---B--|o--|----T----?-------o-o-|---------
----------?--------------|?-|----|---------|----?--T--B-------------M----|-----M------------?---M-------|----T-----B-------------------------?--------f-------------|?--|----|-------------B--|--?------
m--------------E-------E-|E-|--E-|-E-------|------E|---------E-----------|------------E-----------------|----|--------E-----------E-------------------f----E--------|E--|E-E-|---------EE-----|----EE---
XXXXXXXXXXXXXXXXXXXXXXXXXXXXXXXXXXXXXXXXXXXXXXXXXXXXXXXXXXXXXXXXXXXXXXXXXXXXXXXXXXXXXXXXXXXXXXXXXXXXXXXXXXXXXXXXXXXXXXXXXXXXXXXXXXXXXXXXXXXXXXXXXXXXXXXXXXXXXXXXXXXXXXXXXXXXXXXXXXXXXXXXXXXXXXXXXXXXXXXX
