--------------------------------------------------------------------------------------------------------------------------------------------------------------------------------------------------------
--------------------------------------------------------------------------------------------------------------------------------------------------------------------------------------------------------
--------------------------------------------------------------------------------------------------------------------------------------------------------------------------------------------------------
--------------------------------------------------------------------------------------------------------------------------------------------------------------------------------------------------------
--------------------------------------------------------------------------------------------------------------------------------------------------------------------------------------------------------
--------------------------------------------------------------------------------------------------------------------------------------------------------------------------------------------------------
--------------------------------------------------------------------------------------------------------------------------------------------------------------------------------------------------------
---------------------------------------------------------------------------------------------------------------------------------------------------------------------------------------------------v----
-------------------------------------------------------------------------------------o------------------------------------------------------------------------------------------------------------of----
-----------------------------------------------o-o----------------------------------------------------------------------------------------o--------------------------------------o-----------------f----
---------------------------------------------------M--------------------------o---------------------------------------------------o--------------------------------------------------o-------------f----
-----------M----------------------------------------------------------------------------------------------------------o-----o----------------------------------------------o-----M-------------B---f----
-------------------o-------------------------------------------------------------------?-----------------------------------------------------o----------------o------------------------------------f----
---------------------------------M-----------------------------------------------------------------------------------------------------------------------------------------------------------------f----
m-------------------------------------------------------------------------------------------------E------------E-----------------------------------------------------------------------------------X----
XXXXXXXXXXXXXXXXXXXXXXXXXXXXXXXXXXXXXXXXXXXXXXXXXXXXXXXXXXXXXXXXXXXXXXXXXXXXXXXXXXXXXXXXXXXXXXXXXXXXXXXXXXXXXXXXXXXXXXXXXXXXXXXXXXXXXXXXXXXXXXXXXXXXXXXXXXXXXXXXXXXXXXXXXXXXXXXXXXXXXXXXXXXXXXXXXXXXXXXX
