--------------------------------------------------------------------------------------------------------------------------------------------------------------------------------------------------------
--------------------------------------------------------------------------------------------------------------------------------------------------------------------------------------------------------
--------------------------------------------------------------------------------------------------------------------------------------------------------------------------------------------------------
--------------------------------------------------------------------------------------------------------------------------------------------------------------------------------------------------------
--------------------------------------------------------------------------------------------------------------------------------------------------------------------------------------------------------
--------------------------------------------------------------------------------------------------------------------------------------------------------------------------------------------------------
--------------------------------------------------------------------------------------------------------------------------------------------------------------------------------------------------------
--------------------------------------------------------------------------------------------------------------------------------------------------------------------------------------------------------
----------------o---------o-----------o----------------------------oo----------------o-------o-o---oo--o---------o-----o-o---o-oo----o---o-------o-----------------------------------o------o-ooo-------
----------Bo---?---------M-B---B--B------oo?-------o---oo--?-o------B------o--?-o-B-------??------o--?-o?o--o--o-o------??o-----BM--o-M--?-o-B-B----------?-o-------ooB-?-------?-----------M?--o-------
--------B------o--o--o------o----------------?--o-------------M--M--------?-------------------o-o--o--o--oo-oMo-M-?--------Boo--BB-o-o--------o-?-----------------M-o-B-o-M--------M---o--Bo-?o---------
-------o---oM--o--------oB?-------o------ooo-oo-----?---o-----B----o-T----T--------o--------o---------B-----?oo--------------o------M-o-----B-----M-B-o-----B-----o-------------B---M-o--oo-------------
--------o?---Bo----------B--B-----------o-----o---?-M?o--------M--B--|?--?|--o------M---B-----B---o-v------------?-Bo---T-----------Mo-----To-----------o-----T---o-----------oo------T-----o--o--------
-----------------------?-B-----B-----M-----B------------?-------B----|----|-------------------------f---------B----T----|M--T-----------M--|----M------?------|--?---T------T---------|-------B---------
m-----------E---E---E-------E-----E----------------------------------|----|-------------------------f--E-----------|-E--|E--|---------E--E-|------------------|E----E|------|---E-----|--E--------------
XXXXXXXXXXXXXXXXXXXXXXXXXXXXXXXXXXXXXXXXXXXXXXXXXXXXXXXXXXXXXXXXXXXXXXXXXXXXXXXXXXXXXXXXXXXXXXXXXXXXXXXXXXXXXXXXXXXXXXXXXXXXXXXXXXXXXXXXXXXXXXXXXXXXXXXXXXXXXXXXXXXXXXXXXXXXXXXXXXXXXXXXXXXXXXXXXXXXXXXX
