--------------------------------------------------------------------------------------------------------------------------------------------------------------------------------------------------------
--------------------------------------------------------------------------------------------------------------------------------------------------------------------------------------------------------
--------------------------------------------------------------------------------------------------------------------------------------------------------------------------------------------------------
--------------------------------------------------------------------------------------------------------------------------------------------------------------------------------------------------------
--------------------------------------------------------------------------------------------------------------------------------------------------------------------------------------------------------
--------------------------------------------------------------------------------------------------------------------------------------------------------------------------------------------------------
--------------------------------------------------------------------------------------------------------------------------------------------------------------------------------------------------------
---------------------------------------------------------------------------------------------------------------------------------------------------------------------------------------------------v----
----o---------------------------------o---------------------------------------------------------------------------------------------------o--------------------------------------------------------f----
-------------------o------------------------------------------------------------------------------------------------------------------------------o---------o--------------------------------------f----
------------------------------------------------o----------------------------------------?---------------------o---o---------------------------------------------------------M-o-------------------f----
-o--------------------------------------------------------------------------------------------------M------------------TT------------------------------o-M-----B---o------------TT--M------------?-f----
--------------------oo---------------?---------B-------------o-------------------------------TT------------------------||-----o-------------------------------------------------||-----------------f----
---------------------------------------------------------------------------------------------||-----------------------?||-------------------------------------------------------||-----------------f----
m----------------------------------------------------------------------E-----E---------------||----------E----------E--||---E-----------E---------------------------------------||-------E----E----X----
XXXXXXXXXXXXXXXXXXXXXXXXXXXXXXXXXXXXXXXXXXXXXXXXXXXXXXXXXXXXXXXXXXXXXXXXXXXXXXXXXXXXXXXXXXXXXXXXXXXXXXXXXXXXXXXXXXXXXXXXXXXXXXXXXXXXXXXXXXXXXXXXXXXXXXXXXXXXXXXXXXXXXXXXXXXXXXXXXXXXXXXXXXXXXXXXXXXXXXXX
