--------------------------------------------------------------------------------------------------------------------------------------------------------------------------------------------------------
--------------------------------------------------------------------------------------------------------------------------------------------------------------------------------------------------------
--------------------------------------------------------------------------------------------------------------------------------------------------------------------------------------------------------
--------------------------------------------------------------------------------------------------------------------------------------------------------------------------------------------------------
--------------------------------------------------------------------------------------------------------------------------------------------------------------------------------------------------------
--------------------------------------------------------------------------------------------------------------------------------------------------------------------------------------------------------
--------------------------------------------------------------------------------------------------------------------------------------------------------------------------------------------------------
-------------------------------------------------------------------------------------------------------------------------------------------------------------------------------------------------------v
---------------o----------o----o-------o---oo--------o--------------------------------o------------o--------------o-oo------------------oo--------oo--------o----o--o-----o------------o-------o-------f
------M----?--------?-?-B--o----o?---M-oo----Bo-?-o---o?-o-o---o-oB-----B-o--o---?--M--oM-o-B-M-?o-BMB-oM?--B-------?-BM--?o-?---M-o------??o-M----oooM--M-?------M?--o----o----Bo-----o------B--------f
--------o--M-M-?M-o-o?o---B--o--?-M-?---------o-B-M-----o------Moo--o?---?B--o--ooM--oB-o-?M--o--M?o-oo--MB----o---oB---BM---M-?----------o-M-------?------o--M?-----o----o--M-M---B-oB----o-----------f
--------?--M?----T-M-o-----?o--------M--M--o------?--o-------ooo--oBT---BB-?T-M----oM--BMM-----?T----M--oB-o--o-o-oMo---B-T--------o------o----o----B---?--Mo------M-----?M--T-----?--TB----MT?-B------f
----------Bo--o-o|---M-B--o-M--T---M---B---?B---o---ooM--Bo-----T-Mo|-------|-------oo-o--M-----|?-B---TM--M-M---M--o--ooM|---oo----o------o--o-----o-oT---o-?---o--MooB--o--|---?----|--T---|o??o-----f
-------?-----B-M-|--M---------M|--------------??-?------T-------|-?-|M----?-|MM---------?-------|---??-|?-----B-----------|M-?-----------B--M??------?-|--B-M-TM-M------T----|--?-M---|--|---|-T-------f
m--EE-E--E-------|-----E-EE----|------EE---E--E-------E-|--E---E|--E|-E--E-E|---E---------------|------|---EE-------------|-----E-----E-E--------------|------|-------EE|--E-|---EE-E-|-E|-E-|E|EE-E---X
XXXXXXXXXXXXXXXXXXXXXXXXXXXXXXXXXXXXXXXXXXXXXXXXXXXXXXXXXXXXXXXXXXXXXXXXXXXXXXXXXXXXXXXXXXXXXXXXXXXXXXXXXXXXXXXXXXXXXXXXXXXXXXXXXXXXXXXXXXXXXXXXXXXXXXXXXXXXXXXXXXXXXXXXXXXXXXXXXXXXXXXXXXXXXXXXXXXXXXXX
