--------------------------------------------------------------------------------------------------------------------------------------------------------------------------------------------------------
--------------------------------------------------------------------------------------------------------------------------------------------------------------------------------------------------------
--------------------------------------------------------------------------------------------------------------------------------------------------------------------------------------------------------
--------------------------------------------------------------------------------------------------------------------------------------------------------------------------------------------------------
--------------------------------------------------------------------------------------------------------------------------------------------------------------------------------------------------------
--------------------------------------------------------------------------------------------------------------------------------------------------------------------------------------------------------
--------------------------------------------------------------------------------------------------------------------------------------------------------------------------------------------------------
--------------------------------------------------------------------------------------------------------------------------------------------------------------------------------------------------------
---------------------o--------o-o----------o----------o--o---o--o----------o-o-----oo-----------------o--o---o------------oo------o------o---o---o-o-------o-------o------------------------------------
--------M----?--o---o----B----o------oB----------o-o?--MB--Mo--?--o--o---Mo--B---?---o--o---?--?--o----------B----o--------o-?------o-o-------o-oB-B--o-------M-o----B---oB--------o---B---?o-o---------
--------??-o---oo-?----------M-----o--o-----o---o------------o-------------oo--------o------B-o----?-------oB-------?------B--o--B---o?-----------------o---------B-----------?----o--o-----------------
----------------oo-------M----T-MoM------------o---oB---------M-o------T---------------o--------M--T------B-?----o----BT------Mo----------ooB----o-----------------B---T-----o-----------------M--------
v-------Moo--------o---?------|---Mo------?-------T-o---B------o-oM---o|---o--------------------?-o|------------------o|------M----T--?------T--o----------?----o------|--------T-o-T-----o-------------
f-----------M----------------M|------------T??-T--|-------T---------TB-|--------?------------------|-------------------|-----------|-----M---|-------------------------|--T-----|---|-------------------
f----E----E-------------------|------------|---|--|-------|---------|--|------------------E--------|----E--------------|-----------|-----EE--|------------E------E-----|--|-----|---|---------E---------
fXXXXXXXXXXXXXXXXXXXXXXXXXXXXXXXXXXXXXXXXXXXXXXXXXXXXXXXXXXXXXXXXXXXXXXXXXXXXXXXXXXXXXXXXXXXXXXXXXXXXXXXXXXXXXXXXXXXXXXXXXXXXXXXXXXXXXXXXXXXXXXXXXXXXXXXXXXXXXXXXXXXXXXXXXXXXXXXXXXXXXXXXXXXXXXXXXXXXXXX
