--------------------------------------------------------------------------------------------------------------------------------------------------------------------------------------------------------
--------------------------------------------------------------------------------------------------------------------------------------------------------------------------------------------------------
--------------------------------------------------------------------------------------------------------------------------------------------------------------------------------------------------------
--------------------------------------------------------------------------------------------------------------------------------------------------------------------------------------------------------
--------------------------------------------------------------------------------------------------------------------------------------------------------------------------------------------------------
--------------------------------------------------------------------------------------------------------------------------------------------------------------------------------------------------------
--------------------------------------------------------------------------------------------------------------------------------------------------------------------------------------------------------
-------------------------------------------------------------------------------------------------------------------------------------------------------------------------------------------------------v
------o-o---o----o-----o-----o------o-------o-------------------o--------o------o------o-o-o-o-------o--oo-o--o---o-oo-----o-------------------------o------------o-o-o--o---------o------o--oo-o------f
------BB-------o?-B----o-B-----?o--oo--?----o---B-----o-?--o---o---B--oo--??-o-------B--o-o-o---?-----o-o---B-BB--?---B--Bo?--Boo--oBB---?-o--o--------BMBoM--o--Mo--B------B---------?B---Bo-Bo-------f
------oM------?o-M---B---o--o----o----o--o---o--oB-----?o-----o---------M?---o----o-B-----o---B-B-o--------------?oo---o---o-o----o-----?---o--M-Mo--o-oBo?---Boo---oo-M--o-----------Mo------oo-------f
------B-M------o--o-o-o--?----T-----Bo-?----?--B-------o-M----??--------o-oo?---o---B-M-o-o-oo---M--ooBo-B-oo---M-oo-----o----o-o--?-------o--o--oMo--T---oM-o----B--------?-?------Mo----?--oM--------f
---------T--------------oT--M-|-B----o---T----MoB-----------------o--------o------o-M-o---?------oBo--------oM?---M---oT-----B--?-o-T------o-o----M---|?-Mo-------T-B---oo-o-ooo---------o--oT-To?-----f
---------|--B------T--T--|-T--|----BM----|------T--------M------------------------------M-M---T-----B----------T-----?-|--------M---|---------M-------|-M---------|---B?-------M--?----M-----|-|-------f
mEEE---E-|-E-E---E-|EE|-E|-|--|-----EE---|------|---------------------E--E---E------------E---|-------EE-------|E---E-E|E------EE---|E--------E-------|E-EE-------|E-E----E-----EE--E-E-E---E|-|--E----X
XXXXXXXXXXXXXXXXXXXXXXXXXXXXXXXXXXXXXXXXXXXXXXXXXXXXXXXXXXXXXXXXXXXXXXXXXXXXXXXXXXXXXXXXXXXXXXXXXXXXXXXXXXXXXXXXXXXXXXXXXXXXXXXXXXXXXXXXXXXXXXXXXXXXXXXXXXXXXXXXXXXXXXXXXXXXXXXXXXXXXXXXXXXXXXXXXXXXXXXX
