--------------------------------------------------------------------------------------------------------------------------------------------------------------------------------------------------------
--------------------------------------------------------------------------------------------------------------------------------------------------------------------------------------------------------
--------------------------------------------------------------------------------------------------------------------------------------------------------------------------------------------------------
--------------------------------------------------------------------------------------------------------------------------------------------------------------------------------------------------------
--------------------------------------------------------------------------------------------------------------------------------------------------------------------------------------------------------
--------------------------------------------------------------------------------------------------------------------------------------------------------------------------------------------------------
--------------------------------------------------------------------------------------------------------------------------------------------------------------------------------------------------------
-------------------------------------------------------------------------------------------------------------------------------------------------------------------------------------------------------v
-----------oo-o-o---o------------o-o--o-----o--------------o--o---------o--------o-------oo---o-----o-----o--------ooo--------o---o--o--oooo-----------------o--o----o------------o-o------------------f
-----------B--o---M---B-o-----------B--B--o----oo--------BM--------B-o--B-o------------B------------Bo---MBM-M--o-----BM---------?o---------------o-Bo?-o-----M--?---o--o-M-o--?---B--o-----o--B-------f
---------------------o----B-o--oo---Bo----o--B-M-o--M--o----B-B--oo-?----Bo-----------------oo--o----M--M-----M-o-------B-o-o-o-o-M-------B----o--o----------B-----------o-----o-oo--Mo-oo------oo-----f
-------B-B?--?----M--M----o---------oo-----------------T---?---?oo----------oo--M-M----o-o-----MM-B-------To-----?---M-----T----o--?-o---o-?-T-----------o---------o-o-----MMT--o--o-----M-------o-----f
--------M?------M-o------M-----Booo---BTB------BM-B--o-|-oo----??--o-------------?Bo---o---M-----------T--|--o--o-----oo---|M--T-----ooBoTo--|-------Bo-----?---B-----o-T-?oo|B----oo--M--MMT-M--------f
----------M-------M--------------B-----|------T--?---T-|------T-----?----------T----M---B-------M------|--|------B------?--|---|-?-------|---|---M-----------?---M------|----|-?------------|----------f
m---E--E----E-------E---E-E--EEE---E---|E--E-E|---E--|E|E--EE-|------E--EEE--E-|---E-E----E------------|--|--E-EE------E---|-E-|-----E---|--E|-E------EE-E-E----E--EE--E|-E--|E--E-EE-E-EE-E|E--E-E----X
XXXXXXXXXXXXXXXXXXXXXXXXXXXXXXXXXXXXXXXXXXXXXXXXXXXXXXXXXXXXXXXXXXXXXXXXXXXXXXXXXXXXXXXXXXXXXXXXXXXXXXXXXXXXXXXXXXXXXXXXXXXXXXXXXXXXXXXXXXXXXXXXXXXXXXXXXXXXXXXXXXXXXXXXXXXXXXXXXXXXXXXXXXXXXXXXXXXXXXXX
