--------------------------------------------------------------------------------------------------------------------------------------------------------------------------------------------------------
--------------------------------------------------------------------------------------------------------------------------------------------------------------------------------------------------------
--------------------------------------------------------------------------------------------------------------------------------------------------------------------------------------------------------
--------------------------------------------------------------------------------------------------------------------------------------------------------------------------------------------------------
--------------------------------------------------------------------------------------------------------------------------------------------------------------------------------------------------------
--------------------------------------------------------------------------------------------------------------------------------------------------------------------------------------------------------
--------------------------------------------------------------------------------------------------------------------------------------------------------------------------------------------------------
--------------------------------------------------------------------------------------------------------------------------------------------------------------------------------------------------------
---------------------------o--------------------o-------------o----------------------o-------o----o-------------o------o---------o--oo------o---------------------o----o-----o--------------o-----------
------------?M----o--?o-----o----------B--oo------M--o-?--B--B---o-o-------B--------?M-------B--Mo---?--B--?-o-------?o----oMo--?---B----------o-o-o------o---o-?-oo--------B--oM-?---Mo---?------------
----------------------M-----o-o----------o---o------Bo--M-?----------o-?o-Bo------o?--------o----M-o---------B----M-M---o-------M-----o----oo------?M--o----B-M--------o-oo--oo------oo-o-----o-o-------
-------B----M---oo------Bo------o--o-To--o------o-o-----------o---o----?BM--o-oT----o-o--T----------BoB-o--M---oo---TB-oBM--o---oo-oo-o------o-M---B---------------T----Mo-----oT--o------ooT--o--------
--------o-oB-?----T-o-oo---M-------T-|--o----o---o-----To---o-M----o--?---o--?-|---------|-o--oo--B---oTTo------M---|-------T-oo---------Bo---M-------vo?----------|---oo?-?----|B-o--B-T---|----o------
--------------T---|-----?----------|-|--B----M---------|---------B------T------|B--------|-------B-----||-----------|-------|?-----------------M------T--B------?--|--M---------|-------|---|---M-------
m-------------|---|E-------E-E-----|E|-------E---------|-----------E----|------|-----E---|E------------||-----------|-------|---E-----E---------------|---E--------|------------|-------|E--|E-E--------
XXXXXXXXXXXXXXXXXXXXXXXXXXXXXXXXXXXXXXXXXXXXXXXXXXXXXXXXXXXXXXXXXXXXXXXXXXXXXXXXXXXXXXXXXXXXXXXXXXXXXXXXXXXXXXXXXXXXXXXXXXXXXXXXXXXXXXXXXXXXXXXXXXXXXXXXXXXXXXXXXXXXXXXXXXXXXXXXXXXXXXXXXXXXXXXXXXXXXXXX
