--------------------------------------------------------------------------------------------------------------------------------------------------------------------------------------------------------
--------------------------------------------------------------------------------------------------------------------------------------------------------------------------------------------------------
--------------------------------------------------------------------------------------------------------------------------------------------------------------------------------------------------------
--------------------------------------------------------------------------------------------------------------------------------------------------------------------------------------------------------
--------------------------------------------------------------------------------------------------------------------------------------------------------------------------------------------------------
--------------------------------------------------------------------------------------------------------------------------------------------------------------------------------------------------------
--------------------------------------------------------------------------------------------------------------------------------------------------------------------------------------------------------
----------------------------------------------------------------------------------------------------------------------------------------------------------------------------------------------v---------
-----------------o---oo----------------o---o----o------o------o--o---o--o------------------oo--o----------oo--oo----o--oo-----------------------o--------o-------o------o---------------------f--o------
-------?-o---?--------------o?------?--o---M?----o--B---?-o------o--?-?---------o---oo---?-M---o-------?o------------o-----o--?--o----B--oo--o?-------Bo-oo-ooo--?--?-o----oo-M-----o-M---?---f-o-------
---------o-----------oB----ooB-o--M-----o-?-o-o-ooo--o-------M--B---------M-B-o-------oo----B-o-B----B-?---o---o-----?-----o-------------o---------B-o--------?-?-----o-o--?---MB---o-o------of---------
-------------BB-----T-o-MB----?-o----To--oo-M-o------T-------o-M--M-o---o----?-----B------T----o--------o-oo--------Mo--?--------oo-o--o-o----o-o-B-o?--o-oM-T-oo---o-------------T-T-o----B--f---------
------------M-B---oo|--o-o------M---o|--------M---oo-|-o-M-------o--M?-B-o---T-?---o---M--|--o---oo------o-----o---TM----o-oo--T------------------?----------|---o--TM--------?---|-|------o--f-?-------
--------B----------?|--M--?-T-B------|?---?--M-T-----|-----M----B-----B--T---|-B--------MM|-B-----B--T----------M--|-----B-----|---?-------T--M---------B---M|------|-----M-------|-|------M--f---------
m----E----E---------|-------|------EE|---------|-----|---EE--------------|---|E--------E--|----------|--E----------|-----------|-----------|------------E---E|------|-E-----------|-|--E--E---XE--------
XXXXXXXXXXXXXXXXXXXXXXXXXXXXXXXXXXXXXXXXXXXXXXXXXXXXXXXXXXXXXXXXXXXXXXXXXXXXXXXXXXXXXXXXXXXXXXXXXXXXXXXXXXXXXXXXXXXXXXXXXXXXXXXXXXXXXXXXXXXXXXXXXXXXXXXXXXXXXXXXXXXXXXXXXXXXXXXXXXXXXXXXXXXXXXXXXXXXXXXX
