--------------------------------------------------------------------------------------------------------------------------------------------------------------------------------------------------------
--------------------------------------------------------------------------------------------------------------------------------------------------------------------------------------------------------
--------------------------------------------------------------------------------------------------------------------------------------------------------------------------------------------------------
--------------------------------------------------------------------------------------------------------------------------------------------------------------------------------------------------------
--------------------------------------------------------------------------------------------------------------------------------------------------------------------------------------------------------
--------------------------------------------------------------------------------------------------------------------------------------------------------------------------------------------------------
--------------------------------------------------------------------------------------------------------------------------------------------------------------------------------------------------------
--------------------------------------------------------------------------------------------------------------------------------------------------------------------------------------------------------
------------------------o--o---------o--------------------------oo-------------o--------o--------o------------------o--------oo-o----------oo---o--o-------------o-----------------o--------------------
-------B--MB--o----o----ooB----B-MM------oB-----------------M-----?----------?---o-B-ooM?----o?-o--B----o-----o--B-----------?--?----------?------o--?----?--o-M---o--B------B-B-------M-B------o-------
--------------o--?--Bo-?--o-----o-----?----------oo-----o-o-?--o----oB------o-M---------------B-------o-?-----oo-o---o---------B-o------------o-?-------o--o-------oo--------o-----oo----o--o-B-o-------
---------B----o----o----o-----o----o----------T-----------------?----M-----------To-o--M----o------------o---T---------ooMo----?----M---B-----o------M-----oo-T----?--B------?--oBT-------o-o-----------
v-----------o--o----?-----o-------B----o-o--o-|---o------TB--------B--oo------M--|o?---------oT-------?-oo---|-------M--Mo----------?T-o---o---o------M--o----|-----o-?----TB--oo-|----o-M-?-----?------
f--------------------------TT--------MT-?----?|----------|----------------B---?--|------?-----|--------------|----------B------------T-------------------B----|---?--------|------T-?-------?B----------
f----E----------------E----||----E---E|-------|----------|---E---E----------E----|E-----------|--E-----------|E---E--E------E--------|---------E---------E----|------E-----|---E--|---------------------
fXXXXXXXXXXXXXXXXXXXXXXXXXXXXXXXXXXXXXXXXXXXXXXXXXXXXXXXXXXXXXXXXXXXXXXXXXXXXXXXXXXXXXXXXXXXXXXXXXXXXXXXXXXXXXXXXXXXXXXXXXXXXXXXXXXXXXXXXXXXXXXXXXXXXXXXXXXXXXXXXXXXXXXXXXXXXXXXXXXXXXXXXXXXXXXXXXXXXXXX
