--------------------------------------------------------------------------------------------------------------------------------------------------------------------------------------------------------
--------------------------------------------------------------------------------------------------------------------------------------------------------------------------------------------------------
--------------------------------------------------------------------------------------------------------------------------------------------------------------------------------------------------------
--------------------------------------------------------------------------------------------------------------------------------------------------------------------------------------------------------
--------------------------------------------------------------------------------------------------------------------------------------------------------------------------------------------------------
--------------------------------------------------------------------------------------------------------------------------------------------------------------------------------------------------------
--------------------------------------------------------------------------------------------------------------------------------------------------------------------------------------------------------
-------------------------------------------------------------------------------------------------------------------------------------------------------------------------------------------------------v
--------B-----------------------o------------------------------------------------B-BB---------o-------------------------------------------------X--B----------?B?B?-----------------------B------------f
--------------------------------------------X-?----o---------BB?--BB?B??-M-??BB?--------------------------------------BBM---??B?-----------------------------------------------B?----------------------f
------o-------o------o-o-------------BB???BB---------MBB--M?-------------------------------o----------------------------o---------------BB--?---------------------------------------X-------M-BB?------f
---------------------------o--T------------------T-------T----------------o--M?BBB-?---------------X----------X----?-----------------------T--B-??--X---M-X--------X------T----------------------------f
-------------------?----------|----------?B???---|-------|---------------o-------------------o---T-XX----M?--XX--------?B-B?------?BBT--M?o|-o-----BXX--------------------|---X--------T---------------f
-------------T---T------------|---T--T-----------|-------|----------o-T--------------------------|-XXXo-----XXX----------------------|-----|----o---XXX-------------------|------------|---------------f
m-E----------|---|-E----------|--E|--|-------E---|-------|------------|--------------------------|-XXXX----XXXX-----------E----------|--XX-|--------XXXX------------------|------------|--------------XX
XXXXXXXXXXXXXXXXXXXXXXXXXXXXXXXXXXXXXXXXXXXXXXXXXXXXXXXXXXXXXXXXXXXXXXXXXXXXXXXXXXXXXXXXXXXXXXXXXXXXXXXXXXXXXXXXXXXXXXXXXXXXXXXXXXXXXXXXXXXXXXXXXXXXXXXXXXXXXXXXXXXXXXXXXXXXXXXXXXXXXXXXXXXXXXXXXXXXXXXX
