--------------------------------------------------------------------------------------------------------------------------------------------------------------------------------------------------------
--------------------------------------------------------------------------------------------------------------------------------------------------------------------------------------------------------
--------------------------------------------------------------------------------------------------------------------------------------------------------------------------------------------------------
--------------------------------------------------------------------------------------------------------------------------------------------------------------------------------------------------------
--------------------------------------------------------------------------------------------------------------------------------------------------------------------------------------------------------
--------------------------------------------------------------------------------------------------------------------------------------------------------------------------------------------------------
--------------------------------------------------------------------------------------------------------------------------------------------------------------------------------------------------------
----------------------------------------------------------------------------------------------------------------------------------------------------------------------------------------------v---------
------------------------------o----------o-o--o--o-------------o--------------o----------o---o---o--o----o--------------o---------o-------o-----o----------------o------o-o------o--------oo--f---------
-------B-------------B?-------?-o----o----B-M---B--M?---?o------?-----B-----o-B-o----o-o----M-oo-?----------M-?--?-?-MB-------o--B--?----o---o--------B--o--ooo--?o-?----o-Bo--------M--ooBBM-fB--------
------------o?----------------B------oM--B--o------o---M-------M--------o--M-o-----------?--B-o--?-B?o--?M-------------M---------?----o--o----o---?B-o---------------o--o-o------------Bo-----f---------
---------o-B-----?---B--oM--o-------------o------B---------ooo--o-T----B-o-?----oo-oT--o---o-------o------o--T---oB----Too-oo--------o-o------o-----o?-----M?--o----o----o---------?-o---o----f---------
--------B-o----?--?B-----TM-------------B-----------o----o---B?---|-o---T-----M-----|-----------T----o------M|--B------|---o--o---?--------o------??----------o--o--To-?--------M-------------f-o-------
--------?-----M---T------|------M------?------------------------?-|-----|-----------|-----------|-----?----B-|---------|-------------------T--M-------------M?----?-|----M---M----------------f--?------
m-----------------|-----E|---------------E--------------E---E-E---|--E--|-----------|E-E--------|----------E-|---------|-------------------|------------EE----------|-E-----------------------X---------
XXXXXXXXXXXXXXXXXXXXXXXXXXXXXXXXXXXXXXXXXXXXXXXXXXXXXXXXXXXXXXXXXXXXXXXXXXXXXXXXXXXXXXXXXXXXXXXXXXXXXXXXXXXXXXXXXXXXXXXXXXXXXXXXXXXXXXXXXXXXXXXXXXXXXXXXXXXXXXXXXXXXXXXXXXXXXXXXXXXXXXXXXXXXXXXXXXXXXXXX
