--------------------------------------------------------------------------------------------------------------------------------------------------------------------------------------------------------
--------------------------------------------------------------------------------------------------------------------------------------------------------------------------------------------------------
--------------------------------------------------------------------------------------------------------------------------------------------------------------------------------------------------------
--------------------------------------------------------------------------------------------------------------------------------------------------------------------------------------------------------
--------------------------------------------------------------------------------------------------------------------------------------------------------------------------------------------------------
--------------------------------------------------------------------------------------------------------------------------------------------------------------------------------------------------------
--------------------------------------------------------------------------------------------------------------------------------------------------------------------------------------------------------
--------------------------------------------------------------------------------------------------------------------------------------------------------------------------------------------------------
--------oo---o-----------o-----------------------o----oo-------oo--o-------------------------------o-------o------o---o--------o---------o-------------------------------o------o--o--------------------
---------?o--?-o--o-o-?---B------Mo--o?------B------B----o?-o-o-oo-----?------------?o-------o?--------o-oo-o---o--?----?-?-?o------?o----oB--------?---Mo-?--?-o-------o-----?---------o-----B---------
-------------o--M--------o---?ooo----M----o-oM---o--o-o---------------------?--M--------o--M----o----M------Bo----o----o-----------M-------o---o--------Mo------BooB------o--o-M--B--o-o-----?M-oo------
--------B---M-----o--------ooT--o---?--------------o-o---?-----o--------T--?B--?---o--T----------B-------------------o--?-----o-----o-o----------------o-----o-o-o-o-----------------o------To-?o-------
-------o---oB-----oB?---?--o-|-?MM---M-------TB----?-o-oo-T--T---oT-----|--M----TB----|M--o--o-o----v------oM--------MT--o---------------T-B------------?--?----------T----TB---M-----T---M-|?----------
-----------------?---B---T---|---B-------M---T-----------B|--|--B-|-----|-------|--M-M|-M----B----B-f?-M-------------M|-----?---M--------|-TM-------B-----------------|---M|--------?-|-----|-----------
m-----------E------------|E--|E--E-----------|------------|--|----|-----|E------|-----|----E---E----f--E------------E-|--------------E---|-|------E-------------------|E---|------E---|-----|-----------
XXXXXXXXXXXXXXXXXXXXXXXXXXXXXXXXXXXXXXXXXXXXXXXXXXXXXXXXXXXXXXXXXXXXXXXXXXXXXXXXXXXXXXXXXXXXXXXXXXXXXXXXXXXXXXXXXXXXXXXXXXXXXXXXXXXXXXXXXXXXXXXXXXXXXXXXXXXXXXXXXXXXXXXXXXXXXXXXXXXXXXXXXXXXXXXXXXXXXXXX
