--------------------------------------------------------------------------------------------------------------------------------------------------------------------------------------------------------
--------------------------------------------------------------------------------------------------------------------------------------------------------------------------------------------------------
--------------------------------------------------------------------------------------------------------------------------------------------------------------------------------------------------------
--------------------------------------------------------------------------------------------------------------------------------------------------------------------------------------------------------
--------------------------------------------------------------------------------------------------------------------------------------------------------------------------------------------------------
--------------------------------------------------------------------------------------------------------------------------------------------------------------------------------------------------------
--------------------------------------------------------------------------------------------------------------------------------------------------------------------------------------------------------
---------------------------------------------------------------------------------------------------------------------------------------------------------------------------------------------------v----
------------------------------------------------------------------------------------------------------------------------------------------------o--------------------------------------------------f----
-----------------------------------------o----------------------------------------o------------------------------------------------------------------------o---------------------------------------f----
-----------------------o---------------------------------------------------------------------------------------------------B---------------------------o-----------------o-------------------------f----
-------------------------------------o-------------o---------------o------?------------------------------------o----------------------------o--------------------------o-------------------------B-f----
--------------------------------------o-----------------------------B----------------?--------------------------------------------------M----------------------------------------------M-----------f----
--------------------M---------------------------------------------------------------------------------------------------------------------------------------------M--------------------------------f----
m---------------------------------------------------------------------------------------------------------------------E--------------------E-------------------------------------------------------X----
XXXXXXXXXXXXXXXXXXXXXXXXXXXXXXXXXXXXXXXXXXXXXXXXXXXXXXXXXXXXXXXXXXXXXXXXXXXXXXXXXXXXXXXXXXXXXXXXXXXXXXXXXXXXXXXXXXXXXXXXXXXXXXXXXXXXXXXXXXXXXXXXXXXXXXXXXXXXXXXXXXXXXXXXXXXXXXXXXXXXXXXXXXXXXXXXXXXXXXXX
