--------------------------------------------------------------------------------------------------------------------------------------------------------------------------------------------------------
--------------------------------------------------------------------------------------------------------------------------------------------------------------------------------------------------------
--------------------------------------------------------------------------------------------------------------------------------------------------------------------------------------------------------
--------------------------------------------------------------------------------------------------------------------------------------------------------------------------------------------------------
--------------------------------------------------------------------------------------------------------------------------------------------------------------------------------------------------------
--------------------------------------------------------------------------------------------------------------------------------------------------------------------------------------------------------
--------------------------------------------------------------------------------------------------------------------------------------------------------------------------------------------------------
--------------------------------------------------------------------------------------------------------------------------------------------------------------------------------------------------------
---------o--------o-------o----o-----------------------oo--------o----------------------------o-----oo-----o---o-------------o--------o--o--o--o----o-o---o-------------o-----------------o-------------
------------?o---------oo--o-?----------Bo-o?----------o-----?---------B---o-o--o----B--B-o------o---B-------?--o-----B-M-?o-oM--------B----o-B-o-o------B------B--o--o-o--o?oo----------B--B-----------
--------o-o-------o-?----o---M-B-o-----o--o?---o-------?-------o-o----o-----------o-?----------?--o---M---o?----M----o----------B-----?-------B-------M-oB----?o-M-?-o-o------------v------------o------
----------B-----TM-?-------o---o----B-B--oo-----o?--oo----M----o---M-o---o?M-----o----------o-TM--M---------------o-------o?--ooB--o-o----o---o----?----------B-----o-----o---------f--oo-T-------------
-------?B--o---o|--?---o?-o---?--o-oo----o--?B-M-o--T---o-B--BM---o-o----oT--o--------B--o--o-|--Bo------B-M-Bo-?---M-o---?o------------T-o--o---B---M-----T----T---o--------o----B-f--?--|--BM---------
----------B-----|------------?--MM-----------------?|--B------------------|-------------B-----|-?-----------BB--------------------------|--------------T---|----|-M-----T----------Tf-----|---?---------
m--------E----E-|-----------------------------------|--E----E---E--------E|-------------------|------E------E--------E------------------|--------------|---|---E|-E-----|------E---|f-E---|---E---------
XXXXXXXXXXXXXXXXXXXXXXXXXXXXXXXXXXXXXXXXXXXXXXXXXXXXXXXXXXXXXXXXXXXXXXXXXXXXXXXXXXXXXXXXXXXXXXXXXXXXXXXXXXXXXXXXXXXXXXXXXXXXXXXXXXXXXXXXXXXXXXXXXXXXXXXXXXXXXXXXXXXXXXXXXXXXXXXXXXXXXXXXXXXXXXXXXXXXXXXX
