--------------------------------------------------------------------------------------------------------------------------------------------------------------------------------------------------------
--------------------------------------------------------------------------------------------------------------------------------------------------------------------------------------------------------
--------------------------------------------------------------------------------------------------------------------------------------------------------------------------------------------------------
--------------------------------------------------------------------------------------------------------------------------------------------------------------------------------------------------------
--------------------------------------------------------------------------------------------------------------------------------------------------------------------------------------------------------
--------------------------------------------------------------------------------------------------------------------------------------------------------------------------------------------------------
--------------------------------------------------------------------------------------------------------------------------------------------------------------------------------------------------------
-------------------------------------------------------------------------------------------------------------------------------------------------------------------------------------------------------v
--------B-----------------?-----o------------------------------------------------B-B?---------o-------------------------------------------------X--B----------?B?B?-----------------------?------------f
--------------------------------------------X-?----o---------?B?--B?BBB?-?-??BB?--------------------------------------B?M---?B??-----------------------------------------------B?----------------------f
------o-------o------o-o------------??B???BB----------BB--M?-------------------------------o---------o----------------o-o--o------------BBo-?---------------------------------------X-------M-BB?------f
---------------------------o--T-----------------BT-------T----------------o--B?BBB-?---------------X----------X----?--o--------------------T--B-?B--X---M-X--------X------T----------------------------f
-------------------B----------|----------BB???---|-------|-----o---------o-------------------o---T-XX----M?--XX--------?B-B?------B?BT--?Bo|-o-----?XXo-------------------|---X--------T---------------f
------------oT---T------------|--oT--T-----------|-------|------------T--------------------------|-XXXo-----XXX----------------------|-----|----o---XXX---o---------------|------------|---------------f
m------------|---|---------E--|--E|--|-----------|-------|------------|------X-------------------|-XXXX----XXXX-----------E----------|--XX-|---E----XXXX------------------|------------|--------------XX
XXXXXXXXXXXXXXXXXXXXXXXXXXXXXXXXXXXXXXXXXXXXXXXXXXXXXXXXXXXXXXXXXXXXXXXXXXXXXXXXXXXXXXXXXXXXXXXXXXXXXXXXXXXXXXXXXXXXXXXXXXXXXXXXXXXXXXXXXXXXXXXXXXXXXXXXXXXXXXXXXXXXXXXXXXXXXXXXXXXXXXXXXXXXXXXXXXXXXXXX
