--------------------------------------------------------------------------------------------------------------------------------------------------------------------------------------------------------
--------------------------------------------------------------------------------------------------------------------------------------------------------------------------------------------------------
--------------------------------------------------------------------------------------------------------------------------------------------------------------------------------------------------------
--------------------------------------------------------------------------------------------------------------------------------------------------------------------------------------------------------
--------------------------------------------------------------------------------------------------------------------------------------------------------------------------------------------------------
--------------------------------------------------------------------------------------------------------------------------------------------------------------------------------------------------------
--------------------------------------------------------------------------------------------------------------------------------------------------------------------------------------------------------
--------------------------------------------------------------------------------------------------------------------------------------------------------------------------------------------------------
------------------o--o----------o----------o----------o-----------oo-------o-o-----oo------oo------------o-----o--------oo--o------o--------------------------o----ooo--------------o-o-----------------
---------o-------?--o--o-B----oo------B?---------o-o?--MB---o---B-B-Mo-------B-------o---?-----?-------o?--------------?o---o--o?--o-------oB-----oo---?------B-?---o-----------o--------o--o?----------
-------M---M--B--------------M-----o--o--------?o-?------------oM-----------o-------B------------o---B--o-----o-----M----o-------o--M-o-o----------?-------?M------------------B-----o-o----------------
-------o---o----o--oo----MB---T-MoM---o--------o-------------oT--o-----T-o----o------T-o----T-------B------T---TB--------oo-M---------o-------T--o--------M----------T-B----?B----o--M-----BM-M--B------
v----------?-----------?--M--o|---Mo------?-------T-o---B-----|-B-----T|---o---------|------|o----M-----?--|---|?-o-----oo-o-------?-M--B-o-o-|---T-oMo------T--o--oo|oBM----------------TT----M--------
f----------------------------M|------------T??----|-------T---|--M----||--------?----|------|----?---------|---|------------------------------|---|----------|-?-----|----------T--------||-------------
f----------E--EEE-------------|------------|EE----|-------|---|-------||-E-----------|----EE|--------------|---|------E------E---E------------|---|----------|-------|EE---E----|--------||-------E-----
fXXXXXXXXXXXXXXXXXXXXXXXXXXXXXXXXXXXXXXXXXXXXXXXXXXXXXXXXXXXXXXXXXXXXXXXXXXXXXXXXXXXXXXXXXXXXXXXXXXXXXXXXXXXXXXXXXXXXXXXXXXXXXXXXXXXXXXXXXXXXXXXXXXXXXXXXXXXXXXXXXXXXXXXXXXXXXXXXXXXXXXXXXXXXXXXXXXXXXXX
