--------------------------------------------------------------------------------------------------------------------------------------------------------------------------------------------------------
--------------------------------------------------------------------------------------------------------------------------------------------------------------------------------------------------------
--------------------------------------------------------------------------------------------------------------------------------------------------------------------------------------------------------
--------------------------------------------------------------------------------------------------------------------------------------------------------------------------------------------------------
--------------------------------------------------------------------------------------------------------------------------------------------------------------------------------------------------------
--------------------------------------------------------------------------------------------------------------------------------------------------------------------------------------------------------
--------------------------------------------------------------------------------------------------------------------------------------------------------------------------------------------------------
--------------------------------------------------------------------------------------------------------------------------------------------------------------------------------------------------------
-------------o----------------o------o-------------------o-------------o--ooo--o---o------o--------o-----------o----o---o--o---------oo---------------------o-----o-------o------o---------o------------
---------o--B-------o--?o-----M?-Bo----?-o----?oo-B--o-----M----oo--?------o?-?-M------B----B-------M---------B-Mo-M---?o--------Bo-?--o-o-M-B-------M?--------?--------------?---?-----------o---------
------------B--------o-----o------o--o--o-----o---o-?o--o---M---M-----------?-o---o---------o---o---------B-----oo-o-------B-----o------Mo--o-------o-------------o----o---o---?-B----oM----?B----------
--------B---------o---o-------o----oT--Bo---------o-Too-o----oBoo---B-----------------M-------o-----?-------oM---------o-o-----B---------o-o----------o---?----o-----o-?o--------B-Bo-o----T-----M------
--------?------BBo----oM---T--oo----|----oo--?o-----|----------o-----B-T------o-M-----T-?------o---?---B------B----o-------o--------oo-----------M----vB-------------------Mo---o--T-------|----o-------
-------------M-------------|B-----T-|---------?-----|-?-----------TB---|--------------|----M---B------T----------M------?---B?------------B---B-------f--------M---M---T-----?--M--|-------|-----M------
m-------E----E-------E-----|------|-|---------------|-------------|----|--------------|---------------|--E--------E-----------------E-----------------f-----E--E-------|-----------|-------|-----E-E----
XXXXXXXXXXXXXXXXXXXXXXXXXXXXXXXXXXXXXXXXXXXXXXXXXXXXXXXXXXXXXXXXXXXXXXXXXXXXXXXXXXXXXXXXXXXXXXXXXXXXXXXXXXXXXXXXXXXXXXXXXXXXXXXXXXXXXXXXXXXXXXXXXXXXXXXXXXXXXXXXXXXXXXXXXXXXXXXXXXXXXXXXXXXXXXXXXXXXXXXX
