--------------------------------------------------------------------------------------------------------------------------------------------------------------------------------------------------------
--------------------------------------------------------------------------------------------------------------------------------------------------------------------------------------------------------
--------------------------------------------------------------------------------------------------------------------------------------------------------------------------------------------------------
--------------------------------------------------------------------------------------------------------------------------------------------------------------------------------------------------------
--------------------------------------------------------------------------------------------------------------------------------------------------------------------------------------------------------
--------------------------------------------------------------------------------------------------------------------------------------------------------------------------------------------------------
--------------------------------------------------------------------------------------------------------------------------------------------------------------------------------------------------------
-------------------------------------------------------------------------------------------------------------------------------------------------------------------------------------------------------v
-------------o-----o-----o-o-------------o---------------oo---o-oo---------------o--------o-ooo-oo-oo---------------o--o-o---o------oo-----o-o------o----o----o----o-----o-----o---oo---o--------------f
-------o--------o------?--MBM------?BM----o--B-Mo-----B----?--o?-o-o?o-o---B------?-----o-o-M------Boo-?-Mo?-M-o---o?-----?--M------?oo-M?---o--o------B----------o--B-Mo---B--B--ooB----BMM--?--------f
-----------?M--o---BM------------B-o-?-Bo-BBBM--o---??----------o??------M------MB----o--------Bo-B-M---o--?--o--M---o----oM--B-o-o--M------o---------M---------Mo-B---B-?-oo?---ooo?--M---M--o--------f
------B-B--o---M-o------?---o-----------?-oo--B-o--o--Moo----B-B--TT--o-o-------o---oo-o----oTTB----B--------oMTTM------M---oB----oo-----o----MB--ooo---?o--B-oB----------oB?---B---M--Mo--------------f
-------?-oM--oB----o----M-o-------B---o----B---B--oTTB---oo-oo----||o---oo-TTo---oo-----o-oo-||----M--------oo-||---Mo-Mooo--B-o-------o---B-----M-----oooM---M??-------o-oo-ooo-oM--------o---TT------f
---------------B-----B-M-M-B--M------------M----M--||-------------||----B--||-??----TTB--MB--||------?TT------M||?---M---B?--------B---B-M---TT-?-?-----B--T-M-?--BB------------M-------M---TT-||------f
m-E---E-----EE------------E-------E-E-----------E--||----------E--||E---E-E||-------||----EE-||---EE-E||-E-E-EE||--E-E-E---E-E--E---E--------||E--------E--|------E--------EE-----------E---||E||--EE-EX
XXXXXXXXXXXXXXXXXXXXXXXXXXXXXXXXXXXXXXXXXXXXXXXXXXXXXXXXXXXXXXXXXXXXXXXXXXXXXXXXXXXXXXXXXXXXXXXXXXXXXXXXXXXXXXXXXXXXXXXXXXXXXXXXXXXXXXXXXXXXXXXXXXXXXXXXXXXXXXXXXXXXXXXXXXXXXXXXXXXXXXXXXXXXXXXXXXXXXXXX
