--------------------------------------------------------------------------------------------------------------------------------------------------------------------------------------------------------
--------------------------------------------------------------------------------------------------------------------------------------------------------------------------------------------------------
--------------------------------------------------------------------------------------------------------------------------------------------------------------------------------------------------------
--------------------------------------------------------------------------------------------------------------------------------------------------------------------------------------------------------
--------------------------------------------------------------------------------------------------------------------------------------------------------------------------------------------------------
--------------------------------------------------------------------------------------------------------------------------------------------------------------------------------------------------------
--------------------------------------------------------------------------------------------------------------------------------------------------------------------------------------------------------
--------------------------------------------------------------------------------------------------------------------------------------------------------------------------------------------------------
-------o--------------o---------oo----------oo------------o--------------o----o----------o-----o-oo----oo---------o---------o---------------------o-------o---o----o----o---------------o-o-------------
---------o---M?-oo--------?------B---B---------B-B-o-M-B-B---M---?---?---oo-B-----?---o-----?-o?---o--?o--oo-o---o-?--M------?-B--o-----o-B-------o?-----Bo----------o---B-------M----o----------B------
-------BM-o---------M-----------o-------------o--o-----oo--M?------------------?--o---------o---?M-o----o---?--------oo-o--o--o--Mo-----?------------------oB-----------o-o---o--oo-v------o----B-------
-----------------o-B-o--o---BT-o-------------o--oT--------M---o---o-o----M-?-o---B--o----T-B------Mo----o-B------o--------B------B----oo---oB-T-----o-oo-----MM-o----B---T-M-o?-o-o-f---------T---------
-------o---o-------o-o--B-o--|-T------B----------|-----?-------------B--o?-----oo---B-?--|?------M-o-o----o--o--o-M------M-----------o-----o--|-oB-----------o--o---?----|-------o--f---?-B---|o-o------
--------?---?-?--?-----------|-|-----------M-----|---?-B--------M--M----------B----------|-------------M-------?----M--T-?--------T---?-------|-------BBMM---?-M----?-B--|--T-------f--B------|---------
m-----E-----E----------------|-|E--------------E-|----------E----------------------------|-----------------------------|-E--------|-------EE--|--------E-----------E-----|--|-------f--E------|-E-------
XXXXXXXXXXXXXXXXXXXXXXXXXXXXXXXXXXXXXXXXXXXXXXXXXXXXXXXXXXXXXXXXXXXXXXXXXXXXXXXXXXXXXXXXXXXXXXXXXXXXXXXXXXXXXXXXXXXXXXXXXXXXXXXXXXXXXXXXXXXXXXXXXXXXXXXXXXXXXXXXXXXXXXXXXXXXXXXXXXXXXXXXXXXXXXXXXXXXXXXX
