--------------------------------------------------------------------------------------------------------------------------------------------------------------------------------------------------------
--------------------------------------------------------------------------------------------------------------------------------------------------------------------------------------------------------
--------------------------------------------------------------------------------------------------------------------------------------------------------------------------------------------------------
--------------------------------------------------------------------------------------------------------------------------------------------------------------------------------------------------------
--------------------------------------------------------------------------------------------------------------------------------------------------------------------------------------------------------
--------------------------------------------------------------------------------------------------------------------------------------------------------------------------------------------------------
--------------------------------------------------------------------------------------------------------------------------------------------------------------------------------------------------------
-------------------------------------------------------------------------------------------------------------------------------------------------------------------------------------------------------v
------------o---oo-----------------------------o---------o--o-oooo----o----------o------oo----------------o----o---o-----o-----o-----o---o--------oo----------oo---o----o-o--o---o----------o----------f
-------o---?-----B--B------oB--B---o--?-Moo-M-M--?---o---M--?-----Bo--o--?o-----Mo?-----------?o----o-B-oo----?---M?-BM-M-?---M-oo--B-ooo---?---o--?------?----?-?-MBo--BMB-o------o---?----oo---------f
----------o??B---------??o----M---B?-B-----?---o--M--o---B----?-o--?----o-M--o--B--B-------B------oo--oo-oBB---oo-o-o--o?--?-o?-oMBo?--B-M-?-o?-------oB-o?-oM-----M---oM---oB----?-?oo----------------f
------?Bo---oo-oo----B--------oM-------o-o?-oMTM-----Bo--T--T---To--o--?B-MMM------B--o--o-TTMo-B----o-----o-M-----o--B-?M---MT?-o-?--------o-----B-o?--o---ooo--------?---M-To---B--BM-MT-o-----T-----f
--------oo--?-?--------??-o-M---M-----o--?----|-?-------M|-o|---|-B---------?B?o-o-?oo-----||--M---T-M--M?-oMo-B?o-MBMB----B-B|------B----?--T------o--oo--BMoBM----oo--o-o--|--M-o-T----|--B---o|-----f
----------M-?-T------M??-B-?-----------------M|-MT------B|M-|M-?|M--B-?---B---?--?---------||--M?--|---B-B----BTB----------MMB|---------M----|-M-B---------------------?-----|-----?|---M|-----B-|-----f
m-E--EE----E--|----------E----EE---E--E----EE-|E-|-E---E-|EE|--E|E--E-E-E-----E-E-EEE-EEE--||-----E|--EE-----E-|---------E--EE|E-E-E--E------|----EE-----E--E---EE----------E|-EE---|--E-|E-EE--E|-EE-EX
XXXXXXXXXXXXXXXXXXXXXXXXXXXXXXXXXXXXXXXXXXXXXXXXXXXXXXXXXXXXXXXXXXXXXXXXXXXXXXXXXXXXXXXXXXXXXXXXXXXXXXXXXXXXXXXXXXXXXXXXXXXXXXXXXXXXXXXXXXXXXXXXXXXXXXXXXXXXXXXXXXXXXXXXXXXXXXXXXXXXXXXXXXXXXXXXXXXXXXXX
