----------------------------------------------------|M------------------|---------------------------|T--------------------------EM----------------------------------------------------------------------
----------------------------------------------------MM------------------M-----------?---------------X|---------------------------BB---------------------------------------------------------------------
----------------------------------------------------Eo------------------o-----------?---------------|X--------------------------EME---------------------------------------------------------------------
----------------------------------------------------X?------------------E-----------E---------------XE--------------------------BEM---------------------------------------------------------------------
----------------------------------------------------oM------------------E-----------?---------------oX--------------------------|EE---------------------------------------------------------------------
----------------------------------------------------|o------------------|---------------------------XE--------------------------MXE---------------------------------------------------------------------
----------------------------------------------------TT------------------?---------------------------??--------------------------XoX---------------------------------------------------------------------
----------------------------------------------------|-------------------------------?---------------BE--------------------------|oo--------------------------------------------------------------------v
----------------------------------------------------XM------------------X-----------|---------------?o--------------------------M-M--------------------------------------------------------------------f
----------------------------------------------------TE------------------B-----------o---------------MB--------------------------M-|--------------------------------------------------------------------f
----------------------------------------------------X|------------------M-----------?---------------?o--------------------------XBX--------------------------------------------------------------------f
----------------------------------------------------XE------------------|---------------------------M|--------------------------E|M--------------------------------------------------------------------f
----------------------------------------------------?-------------------------------E---------------E|--------------------------o?|--------------------------------------------------------------------f
-----------------------------------------------------?------------------------------X---------------BM--------------------------?-E--------------------------------------------------------------------f
m---------------------------------------------------TB------------------o-----------E---------------?T--------------------------BE|--------------------------------------------------------------------X
XXXXXXXXXXXXXXXXXXXXXXXXXXXXXXXXXXXXXXXXXXXXXXXXXXXXXXXXXXXXXXXXXXXXXXXXXXXXXXXXXXXXXXXXXXXXXXXXXXXXXXXXXXXXXXXXXXXXXXXXXXXXXXXXXXXXXXXXXXXXXXXXXXXXXXXXXXXXXXXXXXXXXXXXXXXXXXXXXXXXXXXXXXXXXXXXXXXXXXXX
