--------------------------------------------------------------------------------------------------------------------------------------------------------------------------------------------------------
--------------------------------------------------------------------------------------------------------------------------------------------------------------------------------------------------------
--------------------------------------------------------------------------------------------------------------------------------------------------------------------------------------------------------
--------------------------------------------------------------------------------------------------------------------------------------------------------------------------------------------------------
--------------------------------------------------------------------------------------------------------------------------------------------------------------------------------------------------------
--------------------------------------------------------------------------------------------------------------------------------------------------------------------------------------------------------
--------------------------------------------------------------------------------------------------------------------------------------------------------------------------------------------------------
--------------------------------------------------------------------------------------------------------------------------------------------------------------------------------------------------------
--------------------------o--o------------o----oo------oo----o-----oo-------------o---o--o-----o-----------o-----o--oo-------o-------o----o----o--o-------------o-o----o---------o----oo---o--o-o-------
-----------o--oB------MB--B----------o--o--BoM--oBB----Boo---oM-----B-B-?-Moo-?-o---o-----??---?o---o?o-M---oB-oB---B------o-o---B-------?B---------B-----?o-M?o------B--M-o-oo-M---o-?M--o--o--B-------
--------B----------o------o--M---o--M--------o----o-o----o---o-o-o-oo--?------M-------o--------B-------o----B-----?--o-----o-?M----o------o?--M--o-?---o--M----o--Moo--oo----o----B?---------oo---------
---------?--M-T--oo--oo--?--o------o-------T-oo-----o?-o-To---o-M----o-----o-----o-o------M-o---o----------------o-----oM---M-----?-----o------M---BMT?ooo-------B----o-oT---o----------T-B-------------
----------B--B|-o---o-?-----o--B--ToBo-----|----?----B-B-|----o---M------?-o--------?---------B---o-v----B--M-Mo---TB-----T---o-o-T-o----?o--oT--M--o|o-o---------?--o--o|o--------Mo-?-|----o----------
--------------|-T---------?-------|----M---|?-----T------|------------------------------------------f--B----M------|-T---M|--T----|----B------|------|--------M----------|B-----M-------|--------?------
m-----------E-|-|-EE-E------E-----|-------E|------|----E-|-E---------------------------------E------f--E-----------|-|----|--|--E-|-EE--------|--E---|-------E---E-E-----|--------------|---E-----------
XXXXXXXXXXXXXXXXXXXXXXXXXXXXXXXXXXXXXXXXXXXXXXXXXXXXXXXXXXXXXXXXXXXXXXXXXXXXXXXXXXXXXXXXXXXXXXXXXXXXXXXXXXXXXXXXXXXXXXXXXXXXXXXXXXXXXXXXXXXXXXXXXXXXXXXXXXXXXXXXXXXXXXXXXXXXXXXXXXXXXXXXXXXXXXXXXXXXXXXX
