--------------------------------------------------------------------------------------------------------------------------------------------------------------------------------------------------------
--------------------------------------------------------------------------------------------------------------------------------------------------------------------------------------------------------
--------------------------------------------------------------------------------------------------------------------------------------------------------------------------------------------------------
--------------------------------------------------------------------------------------------------------------------------------------------------------------------------------------------------------
--------------------------------------------------------------------------------------------------------------------------------------------------------------------------------------------------------
--------------------------------------------------------------------------------------------------------------------------------------------------------------------------------------------------------
--------------------------------------------------------------------------------------------------------------------------------------------------------------------------------------------------------
--------------------------------------------------------------------------------------------------------------------------------------------------------------------------------------------------------
------------------------o--ooo------------------------o------o-o--------------o---------o-----oo----o----------------o-----o-o----o-o---oo-o-o-----o----------o------o------------o------------o--------
--------?---------Bo---o----?---M-------o--------?o------?------o---?--M--M-----?----?-B?-----------?--?-?-------------o--?----B---o---o-oo-B-------------M-----?------------?------o-?---B?Mo---o------
-------------------Mo--o------------o--o-o--------BB--------M-oo--------oo-------??-----B-----??----------o--o-o--?-o-B---------o---------------o-o---o------?-------?-o-o-o---------o---------oo-------
----------M---o-oBoT----T----o--MT---B-o----o---------T--------------------?-----T-----o---o--o----T---T--?-M-o-?B-o----o-o------oT------o------o--o---oM-----o-B-o---M----o--To-oo-B-----T-------------
-------------------|----|?B------|--o--o------?-------|---B----T-o----BM----o-T--|-----------o----B|vo-|----B---o-oo-------?------|--?---B-ooB--o-------------------------T---|-----------|--o---M------
-----------B-------|----|-----M--|--?--------------?M-|--------|?M--?---------|--|-B--------------?|f--|-?-------------M----------|-----M---M--------?----------------M---|--T|------T--B-|-------------
m---E---E---E---E--|----|E-------|-----------E-E------|--------|E--EE---------|--|------------E----|f--|--EEE-----------E---------|---E--E-----------------------E--------|--||------|----|-------------
XXXXXXXXXXXXXXXXXXXXXXXXXXXXXXXXXXXXXXXXXXXXXXXXXXXXXXXXXXXXXXXXXXXXXXXXXXXXXXXXXXXXXXXXXXXXXXXXXXXXXXXXXXXXXXXXXXXXXXXXXXXXXXXXXXXXXXXXXXXXXXXXXXXXXXXXXXXXXXXXXXXXXXXXXXXXXXXXXXXXXXXXXXXXXXXXXXXXXXXX
