--------------------------------------------------------------------------------------------------------------------------------------------------------------------------------------------------------
--------------------------------------------------------------------------------------------------------------------------------------------------------------------------------------------------------
--------------------------------------------------------------------------------------------------------------------------------------------------------------------------------------------------------
--------------------------------------------------------------------------------------------------------------------------------------------------------------------------------------------------------
--------------------------------------------------------------------------------------------------------------------------------------------------------------------------------------------------------
--------------------------------------------------------------------------------------------------------------------------------------------------------------------------------------------------------
--------------------------------------------------------------------------------------------------------------------------------------------------------------------------------------------------------
--------------------------------------------------------------------------------------------------------------------------------------------------------------------------------------------------------
--------------o---o-----o--------o---o---o----o-o----o---oo-----oo--o-----o-----------------------------------------------o---------------------------------o---o---------------------------------------
---------o-B--?o--------o---M--B----oo-----?-o---B-?---?oM-oo--Bo---------------o--B--??Mo-----Bo-oM----Boo---B-M---------------M----oB-o--?----?------o-?------o----B-M----oo?M------B-B--M------------
--------Boo-------------o-------M-?-o--o-o--------o--B-o--o?---?-----o-o?---M---o-o----oo----Mo-------o----o--?o--o--M---?----M----------------o------o--o------?o--o-----------------?o-----?----------
-------o-o--o-oo--o--oT-------o---------oooMT--o-----o?o-B------B----------------o----B--------o-MT-----ooo-----------------?M-----o---oo--o------------------o----Mo--oo---------ooo-o---?Bo-----------
---------oo--B----ooo-|--o-----o----------B-|---o-o-----o-o-o--M----M-o-----TT----T----------?----|o-o----?------------M?--o------o--M--o-o----MTM--o-v-o?--?------oB------B----oB------M-----TB--------
----------B-----------|------------T------?-|-------------?---?-------------||----|--------------B|--T------------B-------------------------B---|-----f-------------T--?----------------M---B-|--?------
m--------E------------|------------|--E-----|------E------------------------||----|----------E----|--|--E-E-------------------------E-----------|-----fE--------E---|-------E-------------E---|---------
XXXXXXXXXXXXXXXXXXXXXXXXXXXXXXXXXXXXXXXXXXXXXXXXXXXXXXXXXXXXXXXXXXXXXXXXXXXXXXXXXXXXXXXXXXXXXXXXXXXXXXXXXXXXXXXXXXXXXXXXXXXXXXXXXXXXXXXXXXXXXXXXXXXXXXXXXXXXXXXXXXXXXXXXXXXXXXXXXXXXXXXXXXXXXXXXXXXXXXXX
