--------------------------------------------------------------------------------------------------------------------------------------------------------------------------------------------------------
--------------------------------------------------------------------------------------------------------------------------------------------------------------------------------------------------------
--------------------------------------------------------------------------------------------------------------------------------------------------------------------------------------------------------
--------------------------------------------------------------------------------------------------------------------------------------------------------------------------------------------------------
--------------------------------------------------------------------------------------------------------------------------------------------------------------------------------------------------------
--------------------------------------------------------------------------------------------------------------------------------------------------------------------------------------------------------
--------------------------------------------------------------------------------------------------------------------------------------------------------------------------------------------------------
-------------------------------------------------------------------------------------------------------------------------------------------------------------------------------------------------------v
------o--------------------o--o--o----oo-o----o---o-oooo-----o------o-o----o---------ooo--------------o-oo---------------o-------o------o--o--------o-------------o------o----o-o----------------------f
----------Bo----o--MMo---M---?---M-M----B---oB-o?-------?-B--oM--o-o-M--B--B-B----B-?-o---B---o--B--?-o--B-o-M--BBo-o-------o-?-------?---------B---oM-B-o---B--M-----??----M------------o------oB-----f
------B-oM--B--oB------o-----Boo--o-----o-----o?--B----M----M-B?o---o----o-oo--?-o-M--BB-B--M--o----------------------oo--M--o---------o--M--?----Bo----o?o----BM--------M-MB----?---oM----?--??-------f
---------------M--M-o------B------?--ooB---M------TT-----------M-oMo--------o----?o--M--?TToo--TT--o----?----o-----?---M-M-M--??B-B-o--o----Moo-o-Bo------o--?oo----ooo----o---------B-----TT----------f
-------B?o--oo-B-o---TT--------?-B-o--oTT-o--o--M-||?----o--B---B---M--TTo---TT---B-B---?||-?o-||---M-MTT-?---------o?--o--------o-o----M?--M------o--M?----?-------o-----oo--------------M||o---?-----f
--------BM-M------TT-||----------------TT---------||---?---------M-----||-?BM||-------M-?||----||------||--------?--B---M------TTB-------M--B----------------B-----M------------M--TT--M?--||----T-----f
mEEE-E---EE---EEE-||E||-E-EE-E--E--E-E-||--------E||---E---------------||----||---E---EE-||--EE||-E-EE-||-----EE---E------EE---||--E----E------------------------------------E-----||------||EEE-|-E-E-X
XXXXXXXXXXXXXXXXXXXXXXXXXXXXXXXXXXXXXXXXXXXXXXXXXXXXXXXXXXXXXXXXXXXXXXXXXXXXXXXXXXXXXXXXXXXXXXXXXXXXXXXXXXXXXXXXXXXXXXXXXXXXXXXXXXXXXXXXXXXXXXXXXXXXXXXXXXXXXXXXXXXXXXXXXXXXXXXXXXXXXXXXXXXXXXXXXXXXXXXX
