--------------------------------------------------------------------------------------------------------------------------------------------------------------------------------------------------------
--------------------------------------------------------------------------------------------------------------------------------------------------------------------------------------------------------
--------------------------------------------------------------------------------------------------------------------------------------------------------------------------------------------------------
--------------------------------------------------------------------------------------------------------------------------------------------------------------------------------------------------------
--------------------------------------------------------------------------------------------------------------------------------------------------------------------------------------------------------
--------------------------------------------------------------------------------------------------------------------------------------------------------------------------------------------------------
--------------------------------------------------------------------------------------------------------------------------------------------------------------------------------------------------------
-------------------------------------------------------------------------------------------------------------------------------------------------------------------------------------------------------v
--------B-----------------------o------------------------------------------------B-BB---------o-------------------------------------------------X--B----------?B?B?-----------------------B------------f
------------------------------?-------------X-?----o---------?B?--BBBBB?-B-B?BB?--------------------------------------B?M---?B??-----------------------------------------------B?----------------------f
------o-------o------o-o--o----------?BBB?BB---------?BB--MB-------------------o-----------o-----------------o----------o---------------BB--?--------------------------o------------X-------M-B??------f
------?----B---------------o--T------------------T-------T-----o----------o--M?BBB-?---------------X----------X----?--o--------------------T--B-BB--X---M-X--------X------T----------------------------f
---o---------o-----B----------|----------??B??---|-------|----------B----o-------------------o---T-XX----M?--XX--------?B-B?-B-----?BT--M?o|-o-----?XX--------------------|---X--------T---------------f
-------------T---T------------|---T--T-----------|-------|----------o-T--------------------------|-XXXo-----XXX----------------------|-----|----o---XXX-------------------|------------|----o----------f
m------------|---|------------|--E|--|-----------|-------|------------|--------------------------|-XXXX----XXXX-----------E----------|--XX-|--------XXXX------------------|------------|-------------EXX
XXXXXXXXXXXXXXXXXXXXXXXXXXXXXXXXXXXXXXXXXXXXXXXXXXXXXXXXXXXXXXXXXXXXXXXXXXXXXXXXXXXXXXXXXXXXXXXXXXXXXXXXXXXXXXXXXXXXXXXXXXXXXXXXXXXXXXXXXXXXXXXXXXXXXXXXXXXXXXXXXXXXXXXXXXXXXXXXXXXXXXXXXXXXXXXXXXXXXXXX
