--------------------------------------------------------------------------------------------------------------------------------------------------------------------------------------------------------
--------------------------------------------------------------------------------------------------------------------------------------------------------------------------------------------------------
--------------------------------------------------------------------------------------------------------------------------------------------------------------------------------------------------------
--------------------------------------------------------------------------------------------------------------------------------------------------------------------------------------------------------
--------------------------------------------------------------------------------------------------------------------------------------------------------------------------------------------------------
--------------------------------------------------------------------------------------------------------------------------------------------------------------------------------------------------------
--------------------------------------------------------------------------------------------------------------------------------------------------------------------------------------------------------
--------------------------------------------------------------------------------------------------------------------------------------------------------------------------------------------------------
----------------o----o-----o-----------------o-------------o-o---o---------------o----------------o-o---o-----------------o----o---------o--o--o----ooo---o-------------o----o---------o--o-------------
--------?---------o------?o-B-------o-----o---B--o--?M---?--------B--o----------B-------B----o----o-?----o------oB--B-----oo-----?----B-----o-B-o-o------B------B--o--ooo--o?oo-------?-??--o-----------
-------------?-oBo--?M-o--o--B--ooM--oB-----oo------------M-ooB------o-o-?oo---------o-o-----M---------B--?-o?---o--------------oo---?-------MB--o----M-oB----?o-M-?-o-o------------v-----o-------------
------------o------o-M--o-o------M----o--To----o-o-?---o-?--B----------o-----T-----?-B-M-----o-o-----?------o----B----------o-B---------------o----?----------B-----o-------------o-fo---o---o--o-------
-------o-----o-----------B--------?------|o---o--o--------------o----o--o----|--?B-----M-o-o-------o-o-----------B----------o---B-----o-T-o------B---M-----T----T---o--------o----B-f--M-o----oB--------
-------B-------M-?-------------------B---|-----T---?-?--------B-------B-----B|-B-----------B-------BM-------T----M---?-B-------------?--|--------------T---|----|-M-----T?----------f--------T---B------
m------E-------E----------------E--------|-E---|----------E-----E------------|--E---------------------------|------------------E--------|--------------|---|---E|-E-----|------E----f-E------|----------
XXXXXXXXXXXXXXXXXXXXXXXXXXXXXXXXXXXXXXXXXXXXXXXXXXXXXXXXXXXXXXXXXXXXXXXXXXXXXXXXXXXXXXXXXXXXXXXXXXXXXXXXXXXXXXXXXXXXXXXXXXXXXXXXXXXXXXXXXXXXXXXXXXXXXXXXXXXXXXXXXXXXXXXXXXXXXXXXXXXXXXXXXXXXXXXXXXXXXXXX
