--------------------------------------------------------------------------------------------------------------------------------------------------------------------------------------------------------
--------------------------------------------------------------------------------------------------------------------------------------------------------------------------------------------------------
--------------------------------------------------------------------------------------------------------------------------------------------------------------------------------------------------------
--------------------------------------------------------------------------------------------------------------------------------------------------------------------------------------------------------
--------------------------------------------------------------------------------------------------------------------------------------------------------------------------------------------------------
--------------------------------------------------------------------------------------------------------------------------------------------------------------------------------------------------------
--------------------------------------------------------------------------------------------------------------------------------------------------------------------------------------------------------
-------------------------------------------------------------------------------------------------------------------------------------------------------------------------------------------------------v
--------B-----------------------o------------------------------------------------B-BB---------o-------------------------------------------------X--?----------?B???-----------------------B------------f
--------------------------------------------X-?----o---------?B?--BBBBB?-M-??BB?--------------------------------------??M---?B??-----------------------------------------------BB----------------------f
----o-o-------o------o-o-------------?B???BB---------MBB--M?----------------------------o--o----------------------------o---------------??--?---------------------------------------X-------?-B??------f
---------------------------o--T------o-----------T-------T----------------o--M?BBB-?---------------X----------X----?------o----------------T--B-??--X---M-X--------X------T----------------------------f
-------------------B----------|----------?B???---|-------|---------------o-------------------o---T-XX----M?--XX--------BB-??------BBBT--M?o|-o-----?XX--------------------|---X--------T---------------f
-------------T---T------------|---T--T-----------|-------|----------o-T--------------------------|-XXXoo----XXX----------------------|-----|----o---XXX------o------------|------------|---------------f
m-E---E------|---|------------|--E|--|-----------|-------|------------|--------------------------|-XXXX----XXXX-----------E----------|--XX-|--------XXXX------------------|------------|--------------XX
XXXXXXXXXXXXXXXXXXXXXXXXXXXXXXXXXXXXXXXXXXXXXXXXXXXXXXXXXXXXXXXXXXXXXXXXXXXXXXXXXXXXXXXXXXXXXXXXXXXXXXXXXXXXXXXXXXXXXXXXXXXXXXXXXXXXXXXXXXXXXXXXXXXXXXXXXXXXXXXXXXXXXXXXXXXXXXXXXXXXXXXXXXXXXXXXXXXXXXXX
