--------------------------------------------------------------------------------------------------------------------------------------------------------------------------------------------------------
--------------------------------------------------------------------------------------------------------------------------------------------------------------------------------------------------------
--------------------------------------------------------------------------------------------------------------------------------------------------------------------------------------------------------
--------------------------------------------------------------------------------------------------------------------------------------------------------------------------------------------------------
--------------------------------------------------------------------------------------------------------------------------------------------------------------------------------------------------------
--------------------------------------------------------------------------------------------------------------------------------------------------------------------------------------------------------
--------------------------------------------------------------------------------------------------------------------------------------------------------------------------------------------------------
-------------------------------------------------------------------------------------------------------------------------------------------------------------------------------------------------------v
--------B-----------------------o------------------------------------------------B-BB---------o----------------?--------------------------------X--B----------?BBB?-----------------------B------------f
--------------------------------------------X-?----o---------?B?--BBBBB?-B-??BB?--------------------------------------B?B---?B??-----------------------------------------------B?----------------------f
------o-------o------o-o----------o--B????BB---------B?B--B?-------------------------------o----------------------------o-----------o---B?--?---------------------------------------X-------M-???------f
---------------------------o--T------------------T-------T------B---------o--M?BBB-?---------------X----------X----B-----------------------T--B-??--X---B-X--------X------T----------------------------f
------------------------------|----------?B???---|-------|---------------o--o----------------o---T-XX----M?--XX--------??-B?------B?BT--B?o|-o---o-?XX--------------------|---X--------T---------------f
-------------T---T------------|---T--T-----------|-------|----------o-T--------------------------|-XXXo-----XXX----------------------|-----|----o---XXX--------o----------|------------|---------------f
m-E----------|---|E-E---------|--E|--|-----------|-------|------------|--------------------------|-XXXX----XXXX-----------E----------|--XX-|--------XXXXE-----------------|------------|--------------XX
XXXXXXXXXXXXXXXXXXXXXXXXXXXXXXXXXXXXXXXXXXXXXXXXXXXXXXXXXXXXXXXXXXXXXXXXXXXXXXXXXXXXXXXXXXXXXXXXXXXXXXXXXXXXXXXXXXXXXXXXXXXXXXXXXXXXXXXXXXXXXXXXXXXXXXXXXXXXXXXXXXXXXXXXXXXXXXXXXXXXXXXXXXXXXXXXXXXXXXXX
