--------------------------------------------------------------------------------------------------------------------------------------------------------------------------------------------------------
--------------------------------------------------------------------------------------------------------------------------------------------------------------------------------------------------------
--------------------------------------------------------------------------------------------------------------------------------------------------------------------------------------------------------
--------------------------------------------------------------------------------------------------------------------------------------------------------------------------------------------------------
--------------------------------------------------------------------------------------------------------------------------------------------------------------------------------------------------------
--------------------------------------------------------------------------------------------------------------------------------------------------------------------------------------------------------
--------------------------------------------------------------------------------------------------------------------------------------------------------------------------------------------------------
--------------------------------------------------------------------------------------------------------------------------------------------------------------------------------------------------------
---------------------o-o---------------------------oo-o-----oo----------------o-----o-o-------------o--------------------------o--o-----o--o-----o------o------------------o---------o------------------
---------B--o---?-o--BM----o-o----?--o---o--o--?M-o--------?---o-----------------B--o---?o-M----?B-------o-B----o---M-?o----o-----?--ooo-o-o-B--------oo-?---o---oo?---------o------?---B---o----M------
---------------o------o-----o-oM---------o-----------M-------o----B?-o------o------------?--M-o-----M---------Bo----o-------o----o-------MM-------o--------o--M-oo---------o-----o------B-o---oo-o------
----------o----M-B-o-o--o---------M-T------------?---o---?----B-------oo-?--------Mo---o----o--o-M-o-----To-BB---M---o---M--T--o-----?---?-o--o-B----M-----o---o-----?-B---o------------o--o-T--o-------
---------ooo-o-----M---BT-----M-----|----oo--------o-?-----o--------oB--o-Moo---M-o-T------o--B------oM--|----T--o----------|B--Bo--------B--------MTov------oo-oo--o---T-----ooo--B-T-o-----|--M-------
--------?---B------?----|----M------T--?--------------M-----------M-T--------B------|M------------------?|----|-------------|---------?-----?B------|-T----------M------|--------?---|-------|----------
m-------EE----------E---|-----------|-E----------------------------E|---------E---E-|--------------------|----|-----E---E---|-----------------------|-|-EE---------E--E-|---E------EE|---E---|----------
XXXXXXXXXXXXXXXXXXXXXXXXXXXXXXXXXXXXXXXXXXXXXXXXXXXXXXXXXXXXXXXXXXXXXXXXXXXXXXXXXXXXXXXXXXXXXXXXXXXXXXXXXXXXXXXXXXXXXXXXXXXXXXXXXXXXXXXXXXXXXXXXXXXXXXXXXXXXXXXXXXXXXXXXXXXXXXXXXXXXXXXXXXXXXXXXXXXXXXXX
