--------------------------------------------------------------------------------------------------------------------------------------------------------------------------------------------------------
--------------------------------------------------------------------------------------------------------------------------------------------------------------------------------------------------------
--------------------------------------------------------------------------------------------------------------------------------------------------------------------------------------------------------
--------------------------------------------------------------------------------------------------------------------------------------------------------------------------------------------------------
--------------------------------------------------------------------------------------------------------------------------------------------------------------------------------------------------------
--------------------------------------------------------------------------------------------------------------------------------------------------------------------------------------------------------
--------------------------------------------------------------------------------------------------------------------------------------------------------------------------------------------------------
--------------------------------------------------------------------------------------------------------------------------------------------------------------------------------------------------------
------------oo-------o--------o---o----o-----o---oo-o-----------------o------o------o----o-----------o--------o----o----oo-----oo----o-o---------------------------o-------------o-----oo----o-o-o------
--------------B-o--M?-M---o------?ooo---M--------?----B---------------?oooo---oM-?-------B-------?--B------B-B---B-oo--o-----?o--M----?--------?-------------B?------?-------B--------B----B-----o------
----------------------o------o-B-----o-------?-----o--------B--------B-----o-----o--B-----?------o--o------o---o-----Bo----B---o----o-M--------------------?-------o--MM--o-----o-----------?-----------
---------------M---o--To-B-------?---B-M--B----o--o---M---B-B--o-----M---o-o-----ooo-o----o-o---M-oM--o--------o-------T--T?-?---o-o-M----T-B--?-M--T------------------o--o-o----------o----Mo--B-------
v----------Bo--Mo----o|--o-----o-Bo--o--M--------o------B--o----?oBo---B--T----o------T---o--o----oo---T--B----oT------|-M|T--o----------M|o-----o--|-----o-T-B---B--o---o-----BMoo-----o----o-o--------
f----------B-T----B-B-|--T-------B-------?-T-------------------------T----|-----------|---?---T-?------|--B-----|-?----|--||-----------M--|--------M|----M--|--T--------------------M-T-----------------
f------------|--------|--|----------E----E-|--------E-------E-----E-E|----|------E----|-------|E-------|E-------|------|--||------------E-|---------|-------|--|E-------E------EE----E|----E-------E----
fXXXXXXXXXXXXXXXXXXXXXXXXXXXXXXXXXXXXXXXXXXXXXXXXXXXXXXXXXXXXXXXXXXXXXXXXXXXXXXXXXXXXXXXXXXXXXXXXXXXXXXXXXXXXXXXXXXXXXXXXXXXXXXXXXXXXXXXXXXXXXXXXXXXXXXXXXXXXXXXXXXXXXXXXXXXXXXXXXXXXXXXXXXXXXXXXXXXXXXX
