--------------------------------------------------------------------------------------------------------------------------------------------------------------------------------------------------------
--------------------------------------------------------------------------------------------------------------------------------------------------------------------------------------------------------
--------------------------------------------------------------------------------------------------------------------------------------------------------------------------------------------------------
--------------------------------------------------------------------------------------------------------------------------------------------------------------------------------------------------------
--------------------------------------------------------------------------------------------------------------------------------------------------------------------------------------------------------
--------------------------------------------------------------------------------------------------------------------------------------------------------------------------------------------------------
--------------------------------------------------------------------------------------------------------------------------------------------------------------------------------------------------------
--------------------------------------------------------------------------------------------------------------------------------------------------------------------------------------------------------
------------------------o--o--------------------------o-------------o--------------------o-------o----------o-----o----o-o-----------------------------o-o---------------------------------o---o--------
---------BM-B-o---o--------B-----o-----Mo--?-o---B----o------o--?--o-B-----B----o-------o---?-o--M---B----o-----------?M-----------?-?---o----B--o-?--o-M-----?-----o---o----?--M--------?-------o------
---------o--o---------B--------?--Mo-----o-M----B--o----?---o--o---o-------------------o--o--------------------?--o-------------oo---M----------M----Boo-M?--------------??o--o----o---------o----------
-------o---------oM-----To------BB------o---o--T-o------------?---------oT---T----B-M--o---?oo--o---o---M---?----------------o---o-------M------o----o-o-M-------To----B----o-----T-o------M--T---------
----------BM------------|-----T-------B----M---|-------B--------------M-o|---|-----o--------oo---?-o-o--T-----o----Bo--o---oo-o--?---o--B--B-oMo------vo---T-----|----o-o------o--|o----T-----|---------
----------?---------?---|-----|--M--------T----|-------T---------T--M----|---|-M----------------M-------|----T-----B----------------------------M-M---T--B-|-----|-----T-B--------|-----|-----|B--------
m-----------------------|----E|-----------|----|----E--|-----E---|-------|---|--------------------------|----|--------E-----------E-------------------|E---|-----|--E--|--E-------|-----|-----|----E----
XXXXXXXXXXXXXXXXXXXXXXXXXXXXXXXXXXXXXXXXXXXXXXXXXXXXXXXXXXXXXXXXXXXXXXXXXXXXXXXXXXXXXXXXXXXXXXXXXXXXXXXXXXXXXXXXXXXXXXXXXXXXXXXXXXXXXXXXXXXXXXXXXXXXXXXXXXXXXXXXXXXXXXXXXXXXXXXXXXXXXXXXXXXXXXXXXXXXXXXX
