--------------------------------------------------------------------------------------------------------------------------------------------------------------------------------------------------------
--------------------------------------------------------------------------------------------------------------------------------------------------------------------------------------------------------
--------------------------------------------------------------------------------------------------------------------------------------------------------------------------------------------------------
--------------------------------------------------------------------------------------------------------------------------------------------------------------------------------------------------------
--------------------------------------------------------------------------------------------------------------------------------------------------------------------------------------------------------
--------------------------------------------------------------------------------------------------------------------------------------------------------------------------------------------------------
--------------------------------------------------------------------------------------------------------------------------------------------------------------------------------------------------------
-------------------------------------------------------------------------------------------------------------------------------------------------------------------------------------------------------v
----------------------oo--o--------oo--o----------------o-oooo--o-o-----o-oo--o----o------o--------------o--------o--o--o--------o----------oo--oo---oo------o--o---------o-oo-------------o----o------f
------------o---oo------------o-----oo-----o-o----o--o--o-o--o--------------------o-oo-------o--------------o--o----o----oo----o--o--------oo-o--o---------ooo-o-o--oo------oo----o-----ooooo---o------f
------o-o-o-----o-----o---o---o-o--------oo----o--o--------oo-o------o-o-o-o-o--oo---o-oo-o-------o---o--o----o-o------o--oo----o----o----------o------o--o---o--oo-o-ooo------o----o----oo-o--o-o-----f
---------o--oooo----o------o-o-------oo-o-----------o--o-oo------------------o-----o-ooo---------o------oo---------o------o------o-----------o--o---------oo---o-----------------o----o-------o--------f
--------T-----o------T--oT--To---o------o-To-o----T-To----o--TTTo--o---oT---ooo-TT--To------o----------T--T------o--ToTT-T----oo--oT-o------T-------o-------ooTo----------T---TT-oo----T--T--o--o------f
--------|-T----------|---|--|--T----T-T---|----T--|-|-TT---T-|||--------|---T--T||--|----T------T----T-|--|---------T-||-|T---T----T----T---T-T-T-------------|-----T----T|---||-------|--|---T--------f
m------T|-|---EEE----|---|T-|ET|---E|-|--E|-T--|--|-|-||--E|-|||E-----EE|--E|--||TE-|ETE-|-----T|ETE-|-|-E|-T---TEE-|-||-||---|-E-E|--E-|-EE|E|-T-----EEEET-E-|-E---|ETT-||---||-------|E-|E--|-E------X
XXXXXXX--XXXXXXXXXXXXXXXXXX----|XXXX|XXXXXXXXXXXXXXXXXXXXXXXXXXXXXXXXXXXXXXXXXXXXXXXXXXXXXXXXXXXXX|XX|XXXXXXXXXXXXXXXXX---XXXXXXXXXXXXXXXXXX|XXXXXXXXXXXXXXXXXXXXXXXXXXXXXXXXXXXXXXXXXXXXXXXXXXXXXXXXXXX
