--------------------------------------------------------------------------------------------------------------------------------------------------------------------------------------------------------
--------------------------------------------------------------------------------------------------------------------------------------------------------------------------------------------------------
--------------------------------------------------------------------------------------------------------------------------------------------------------------------------------------------------------
--------------------------------------------------------------------------------------------------------------------------------------------------------------------------------------------------------
--------------------------------------------------------------------------------------------------------------------------------------------------------------------------------------------------------
--------------------------------------------------------------------------------------------------------------------------------------------------------------------------------------------------------
--------------------------------------------------------------------------------------------------------------------------------------------------------------------------------------------------------
-------------------------------------------------------------------------------------------------------------------------------------------------------------------------------------------------------v
-------o--------------o----ooo--o-------oo-o-o----o-----------------oo-o-o-oooo---o-o----o------o-o-o--o-----o----o-----o-------------------o-----o-oo--o-o-o-o--oo--o----o--oo---o-o---oo--oo-o-o-----f
------?---o---o--BMoo-M-Bo---?-oo???oo-o---o?o---B--oB---MMo-B-o----B?-B-oo-o----BoM-M?-o--Bo--o?oB-M--M?-----B--o---?--?-o-----?--o-M---o---B--o-?MoBo-M-oB-o--?--M-B?ooMMo??Bo----?BMo----o---BM-----f
------ooo-oooo---?-?--?--M--ooo-----Mo---M---oB-oB-B---o-B-B-Boo--o--Mo------oM----ooo-o-------?-oB?--o---M--o---o---------B-M-----Boo---oo-?--o-o--M---o-?Moo--ooMo-o----M-o-M-o-o-?------?-o--B------f
-------oo--o--oMT---M--o-oT----?o-----M?M--o---o--oT-o--B--oT-o-?--MooB-ooo?--o-?----ooo----B--MB---T-o-o--ooMoo--------o---o-----o?o----?o-o-oo-M-?-?-oooo?-o?---M---oo-o--M--ooooM------Mo--?-T------f
------o---B--ooT|-oo-o-o--|To----oM-MBT-M-M-B-oMoB-|?Bo-M-oMT-oo-----Mo-?BooMo-oo--??ooMMTB---oMo--o|-B--T--T--------M------o--o---T-Mo-M--M---M--B---------MM-o-------TB-oBM-B-?oM------o?-Bo-o|------f
-----------?-?-||--M?-----||---T-M?-T-|----M------M|---?BM--|-----?-M?T-?---T?---M-MT---B|-------T-M|--M-|--T----T-----------B--B--|--M---MT?-------------B-T-B--T----T|T-M------BM---?--M------|M-----f
mEE-EE-E-E---EE||E--E---EE||---|E-E-|-|---EE---EE--|--------|--EE---EE|-EE--|------E|-E--|-------|--|----|--|----|--E-----E--------|-------|-------E--------|-E-E|E--E|||-------------E--------E|------X
XXXXXXXXXXXXXXXXXXXXXXXXXXXXXXXXXXXXXXXXXXXXXXXXXXXXXXXXXXXXXXXXXXXXXXXXXXXXXXXXXXXXXXXXXXXXXXXXXXXXXXXXXXXXXXXXXXXXXXXXXXXXXXXXXXXXXXXXXXXXXXXXXXXXXXXXXXXXXXXXXXXXXXXXXXXXXXXXXXXXXXXXXXXXXXXXXXXXXXXX
