--------------------------------------------------------------------------------------------------------------------------------------------------------------------------------------------------------
--------------------------------------------------------------------------------------------------------------------------------------------------------------------------------------------------------
--------------------------------------------------------------------------------------------------------------------------------------------------------------------------------------------------------
--------------------------------------------------------------------------------------------------------------------------------------------------------------------------------------------------------
--------------------------------------------------------------------------------------------------------------------------------------------------------------------------------------------------------
--------------------------------------------------------------------------------------------------------------------------------------------------------------------------------------------------------
--------------------------------------------------------------------------------------------------------------------------------------------------------------------------------------------------------
-------------------------------------------------------------------------------------------------------------------------------------------------------------------------------------------------------v
------oo--o----o----------o----------o-o---o---o----------o--o------o---------------o---o----oo---o-----------o----o------o-oo----o----o-oooo-o---------oo------------o---o-----o----------o----o------f
------B-BB---M-----o--oB---o--B------?-M-B-o-o-o--o-MB-B----o--o---BoM-Mo--?-?B-------?---??-oB-oo----o-?--o--o--o-o-B----?-----?--M---o?B?----?-Mo--?-M--MBo-----MB----B-?----B----B-oo---------------f
----------o------oBo----Mo--o--B----BM-----------M---B---o-o?---o--o--ooM---o--oo--??--B-B---------o-B---M-oo-ooo---o--------oBo---o-oM?------o-?M--------Mo--o-----M---B---Boo-o-------------MBo------f
--------oMoo-B?-T---?o-----B--------T?-------o------o-o---------oo--T--B--B--?--B------?-----M--M---o------oo--oM-M---o-M--To-------o---o------o--?TT--?-M--o---BT--MBoo--M--------------------T-------f
------B--oo--oo-|o------?BB----M-oo-|--------o--o--o---oo-BTo--?Mo?-|----oo-BMo---o--Mooo-o--o-T--oM?-oo--M---o--o----M---?|o-M--B---oBTo--?-?-ooo?||--o------o-o|--?o----B-o-oo-M--M-o----o--o|B?-----f
--------?------?|--------M--?-------|TB-------M----BM------|-M?-----|---M-B-MM--B----B----M----|---B?-------------??--?M-B-|----?--T---|B---MM-?--?||------------|-----------------------------|-M-----f
m---E--EE----E-E|-E----------E-E-EE-||---E--E--E-----------|--------|--------------------E-EE--|------------EE-----E-----E-|E-EE---|---|--------E--||--------E---|-E--E-E------E---E-E--E------|--E----X
XXXXXXXXXXXXXXXXXXXXXXXXXXXXXXXXXXXXXXXXXXXXXXXXXXXXXXXXXXXXXXXXXXXXXXXXXXXXXXXXXXXXXXXXXXXXXXXXXXXXXXXXXXXXXXXXXXXXXXXXXXXXXXXXXXXXXXXXXXXXXXXXXXXXXXXXXXXXXXXXXXXXXXXXXXXXXXXXXXXXXXXXXXXXXXXXXXXXXXXX
