--------------------------------------------------------------------------------------------------------------------------------------------------------------------------------------------------------
--------------------------------------------------------------------------------------------------------------------------------------------------------------------------------------------------------
--------------------------------------------------------------------------------------------------------------------------------------------------------------------------------------------------------
--------------------------------------------------------------------------------------------------------------------------------------------------------------------------------------------------------
--------------------------------------------------------------------------------------------------------------------------------------------------------------------------------------------------------
--------------------------------------------------------------------------------------------------------------------------------------------------------------------------------------------------------
--------------------------------------------------------------------------------------------------------------------------------------------------------------------------------------------------------
-------------------------------------------------------------------------------------------------------------------------------------------------------------------------------------------------------v
-------------o-----oo--o---o--------o--o---------------------------------o------oooo---------------------------------------------o------------o-oo------o--oo-o-o--------o------------o----o-----o-----f
-------?----oB-------B-?B--B--o---?----o---??-o----M-MM------o--?--------?----------oBB------o-M--o?---Bo------B-----------Boo----o---o?oo---MB----?o-------------B----o--B----B-----oB--o---B---------f
---------Moo---ooo-----M----o---M?M-o-?----Mo-BM-o-o---o---?-?-?o-M---o--o-?MM-o---M----o--o----------?-o-o-M---M----o-----?------ooBo----MMM--------oo?o-B------o-M--o--?--o---o-ooB--M--o------------f
------oo--o---oM----o-o-?-M-M-BB--B---?--------------?-o?-------o-M----o----oo-------B---M-TT------B--BMo--o---?o---o--o-B--?---o---------oo--oB---Mo-MM-MMM--o-----------o-?--------ooM-BBo-----------f
------Mo?o----o--------TTo---------------?------------B--B----o-?o----M-B---o----M-B--TT---||----------?----?-o------o----oB----B--o-o--M----o----?--TT-------o---------o--o----?---oBTTM?-BM---TT-----f
-------?----B--BB------||-------BM-------------B---TT---------------M-------------M---||-M-||--M-B-------------------------TT---------------M--B-----||-------------------------------||-----M?-||-----f
m-E---E---E------------||E----E---EE-EEE---E-------||--------------E-EE--EE-------EE-E||---||------------------------------||--E-EE-------E----------||E-----------E------------------||--E-----||-E-E-X
XXXXXXXXXXXXXXXXXXXXXXXXXXXXXXXXXXXXXXXXXXXXXXXXXXXXXXXXXXXXXXXXXXXXXXXXXXXXXXXXXXXXXXXXXXXXXXXXXXXXXXXXXXXXXXXXXXXXXXXXXXXXXXXXXXXXXXXXXXXXXXXXXXXXXXXXXXXXXXXXXXXXXXXXXXXXXXXXXXXXXXXXXXXXXXXXXXXXXXXX
