--------------------------------------------------------------------------------------------------------------------------------------------------------------------------------------------------------
--------------------------------------------------------------------------------------------------------------------------------------------------------------------------------------------------------
--------------------------------------------------------------------------------------------------------------------------------------------------------------------------------------------------------
--------------------------------------------------------------------------------------------------------------------------------------------------------------------------------------------------------
--------------------------------------------------------------------------------------------------------------------------------------------------------------------------------------------------------
--------------------------------------------------------------------------------------------------------------------------------------------------------------------------------------------------------
--------------------------------------------------------------------------------------------------------------------------------------------------------------------------------------------------------
-------------------------------------------------------------------------------------------------------------------------------------------------------------------------------------------------------v
------------o-------o----oo--o-o----------o-----o--o--o--oo-o-----o-----------o--oo-o--------o----o--o-----o--o--o-o--o---------------o-o---oo-o--------ooo----o--o---oooo----o---------o-oo-o--o------f
------?B------o----Bo-B-oB-M?o-o?--o-Mo----B-B--o-----?--o--?o---?--oMo-o--o-?--?-?oMoo?MBo-B-----o--?o-?------B-B-o---o?Mo--oo-BM-o-oM-Bo--B-o--o-B-o-B-Moo----ooBo-o-MoB?--??--o-----B-o--o-oMB------f
-------------o--oo--o-o-o-M---?--?o--MM---B-M---ooo--Mo-Mo-o----o?---o-o?---M--Mo-------o--------o----o-oo-o-oBo-BB--?oBoM?M---M?-M-oooo---M-B---o-M-oo-o-B---M---o?-M--o--o--o--M----B-B-------oo-----f
-------?-----BM?-o-o-?-?M--o-------M-oB----M-?--?--------?-?o-BM--?o-ooM--o--o-?o?o-M------B----o--oMo-?----o?--Booo-----o-o--Mo---oM-----o-M?o-Mo-oo?--ooo-MM-?-oB-----o-o-o--ooM-?-o-o-----o?oo------f
-------TB-o--T--MM---?o---B-o--ooBTo-o-o-o-oo-o-BMM-MB-o---oo--M-TB-------oM--o-oB-T---oo---o--Too?--B-o----o-M?-BM-?T----o??o----BT-o-MoBMo---ooo-oo--oT?MM--?----M-B-o?----oo--ooo--o-B--M--oM-T-----f
-------|M-B--|--B-B--T-B-M-B---M--|--M-?T?-T----?--B-T------M--M-|-----M----M-----?|-M-M-------|-M-B-?----B-------T--|-----T-B-----|?-M--?---------B-M--|-------?-M--------T--?-----M-?---B------|-----f
mEE-E-E|-E-E-|EEE----|EEEET---E---|EEEE-|--|---E-----|ET-E-EE-E--|--E-EEE----T-----|--E-E-TEEE-|E------ET---------|-E|-E---|-E--E--|E----T--E-E--------T|---T---T-EE--EE--E|-E-E--EE---E---EE---E|E--EEX
XXXXXXXXXXXXXXXXXXXXXXXXXX|XXXXXXXXXXXXXXXXXXXXXXXXXXXXXXXXXXXXXXXXXXXXXXXXXXXXXXXX|XXXXXXXXXXXXXXXXXXXXXXXXXXXXXXXXXXXXXXXXXXXXXXXXXXXXXXXXXXXXXXXXXXXXXXXX|XXXXXXXXXXXXXXXXXXXXXXXXXXXXXXXXXXXXXXXXXXX
