--------------------------------------------------------------------------------------------------------------------------------------------------------------------------------------------------------
--------------------------------------------------------------------------------------------------------------------------------------------------------------------------------------------------------
--------------------------------------------------------------------------------------------------------------------------------------------------------------------------------------------------------
--------------------------------------------------------------------------------------------------------------------------------------------------------------------------------------------------------
--------------------------------------------------------------------------------------------------------------------------------------------------------------------------------------------------------
--------------------------------------------------------------------------------------------------------------------------------------------------------------------------------------------------------
--------------------------------------------------------------------------------------------------------------------------------------------------------------------------------------------------------
-------------------------------------------------------------------------------------------------------------------------------------------------------------------------------------------------------v
---------------o---oooo---------o--o----o-o-o------oo-----o-----o----o---------oo--o--------------oo---o--o---o-oo---o------oo------o------ooo--oo-----------o--o-----o--o-----o----o----o----o--o-----f
--------oo--o----oo--------o-o---o-oo---ooo-----o------o-----------ooooo-----o----o--oo---o-----------o-o--o---o-----ooo--o-oo--ooo-------o-o----o---------o-o---o-----o-o----------------o-oo--o------f
-------o-----o--------oo---oo----o---------oo---o-------o--o---------------------o-oo------oo--------o-o--o---o--ooo-o--o---o--oooo--o-o-----oo-o------o--o---o---------oo---o---o-oo-o---oo---o-------f
------------o--oo-------o----------ooo-----oo-oo--o--o-o-oo-o-ooo---o--------o---o---o---------o--o-----o----o-oo---o--o-------o-----o-------o-------o----oo---o-----o---oo-ooooo----------oo--o-------f
-------T-------ooo--T--o------To-o-oTT------To--o------o-----------ToToo-TT---o--T-T----------oo---oTT----T---oo--T--T--oT--Too-o----oo--o--T-------o------o--To-------------o-T--T-----o-T-----o------f
-------|-TT---------|---T-T---|-----||------|-TT----------T--------|-|---||-T----T-|----------------||T---|-------|--|---T--|T------TT------|-T-T-------------|--------T-------|--|------TT---T--------f
m-----E|-||E-E----E-|-E-|E|EE-|-E---||-E----|-||-E----E--E|-E-E---E|-|E--||-|-E--|E|-T--T-----TE-E--|||-TT|EE-----|--|--T|-T||-EE-ET||E---E-|E|-TT--E-EEEETEE-|-EE--E-E|------E|--|------||---|E-E-----X
XXXXXXXXXXXX----XXXXXXXXXXXXXXXXXXXXXXXXXXXXXXXXXXXXXXXXXXXXXXXXXXXXXXXXXXXXXXXXXXXXXXXXXXXXXXXXXXXX|XXXXXXXXXXXXX|XXXXXXXXXXXXXXXXXXXX--XXXXXXX--XXXXXXXXXXXXXXXXXXXXXXXXXXXXXXXXXXXXXXXXXXXXXXXXXXXXXX
