--------------------------------------------------------------------------------------------------------------------------------------------------------------------------------------------------------
--------------------------------------------------------------------------------------------------------------------------------------------------------------------------------------------------------
--------------------------------------------------------------------------------------------------------------------------------------------------------------------------------------------------------
--------------------------------------------------------------------------------------------------------------------------------------------------------------------------------------------------------
--------------------------------------------------------------------------------------------------------------------------------------------------------------------------------------------------------
--------------------------------------------------------------------------------------------------------------------------------------------------------------------------------------------------------
--------------------------------------------------------------------------------------------------------------------------------------------------------------------------------------------------------
-------------------------------------------------------------------------------------------------------------------------------------------------------------------------------------------------------v
------o--------o----o-----------------------------o---------o-------o-o-----oo----o--oo----o--o-----------o-----------oo--o-------o---------------o---o-o---------------oo-o--o-----o----o-------------f
-------o-oo---o-----o-------------------------------o-------o-o-----------o---o-o---------------o------o--o---oo--------ooo-------o--------o-----o---ooo-o--o----oo----o-------------------------------f
-------------------o----------o--------o------oo--o-o--o---o-------o-------o-o---------o----o---------------o---------o--oo------o-oo-o--o--o-----------o----o-------------------o-o--o---oo-----------f
--------o-ooo---o------oo-----------------------o----oo----oo-o--o--------------------o--o------oo-o----------------o----o-----o-----------o---------------o-o-o--------------oo-----------oo----------f
---------------------T---T--To--------T--T--T-------T---oT-------o--T----o--o-T-o---oo---------------T-----o---ToT-----To-o-To---------o-oo--------oooT--o--------o----T-oo---T-o-------o-T----oo------f
------------T---T----|---|T-|T--------|T-|--|-------|----|----------|---------|------T---------------|---------|-|-----|----|--T-----------------T----|-T--------------|------|----------TT-----T------f
m---------E-|---|---E|T--||-|T-E------||-|-E|--E--EE|----|--E-ETT-E-|------E--|E-E---|EE-T-----E-T--E|-TE--EE-E|-|ET---|E---|-T|--E-E-E-E--------|E---|E|--E--T----T-T-|E-E---|----------||----T|------X
XXXXXXXXXXXXXXXXXXXXXXXXXXXXX|XXXXX--XXXXXXXXXXXXXXXXXXXXXXXXXXXXXXXXXXXXXXXXXXXXXXXXXXXX|XXXXXXXXXXXXXXXXXXXXXXXXXXXXXXXXXXXXX|XXXXXXXXXXXXXXXXXXXXXXXXXXXXXXXXXXXXX|XXXXXXXXXXXXXXXXXXXXXXXXXXXXXXXXXX
