--------------------------------------------------------------------------------------------------------------------------------------------------------------------------------------------------------
--------------------------------------------------------------------------------------------------------------------------------------------------------------------------------------------------------
--------------------------------------------------------------------------------------------------------------------------------------------------------------------------------------------------------
--------------------------------------------------------------------------------------------------------------------------------------------------------------------------------------------------------
--------------------------------------------------------------------------------------------------------------------------------------------------------------------------------------------------------
--------------------------------------------------------------------------------------------------------------------------------------------------------------------------------------------------------
--------------------------------------------------------------------------------------------------------------------------------------------------------------------------------------------------------
-------------------------------------------------------------------------------------------------------------------------------------------------------------------------------------------------------v
-----------o----o--o----o---o---oo------ooo---------ooo-o-o-oo----o---o-o-oo-o---o-o---o---o--o-o-o-o---oo-oo--------o------o------o---o------oo---o---------oo-o--oo-o-oooo-o------oo-o---------------f
--------o-ooo-----o---------------o----o--o---oo------o----o--o---o--o---o-----o---------o----o-o---o---oo---o---o-----o--------------o--------------------o-o--oo-----o-o-oo---ooo---------o----------f
-------o-o----------oo---------o--o----o------------ooo-----o-o-----oo---o------o-oo-o-o----o---o-o---o--------o----------o----------o----o----o---oo-oo--o---o---------o----ooo-----ooo-o------o------f
-------o--o--o--o-----oo-----------ooo---o-o----o-o---o--o-----o----o--oo-oooo-----o-oo--oo----ooo-o--------o--oo---o--------o-------o-o-----o------o--oo-o----o----------o-------o--oo----o---o-------f
-------TT----TT-------T---oTT----oT--o--------o---T--T--oT----T-o--o---oTo------TTo-T-o---ooT--o--o---o---T-oT-oo--o-ooT-o-To----o-ooT----T-TTToT---o-T-------Tooo---------oo-ooT--oT---o-T--o---T-----f
-------||----||---T---|----||---T-|--T--------TT-T|--|---|----|---------T---T--TT|--|------T|-------------|--|----T----|---|---------|--T-|T|||-|-----|-------T-----------------|---|-----|------|-----f
m-----E||-E-E||-E-|---|EE--||---|ETTE|T-------||-||T-|-E-|-T-T|-T-T---EE|-E-|--|TT-E|-T-ET-||E-----T-EE-TE|TE|T--T|TTT-TT--|T--T-T-E-|E-|-|||||E|E---TTE--TE--|----E--EE---E--E-|---|TETTE|-E----|-----X
XXXXXXXX|XXXXXXXXXXXXXXXXX--XXXXXXXXXXXXXXXXXX|XXXXXXXXXXXXXXX--XXXXXXXXXXXXXXXXXXXXX--XXXX|XXXXXXXXXXXXXXXXXXXXXXXXXXXXXXXXXXX|X|XXX|XXXXXXXXXXXXXXXXXXXXXX--XXXXXXXXXXXXXXXXXXXXXX|XX|XXXXX--XXXXXXXXX
