--------------------------------------------------------------------------------------------------------------------------------------------------------------------------------------------------------
--------------------------------------------------------------------------------------------------------------------------------------------------------------------------------------------------------
--------------------------------------------------------------------------------------------------------------------------------------------------------------------------------------------------------
--------------------------------------------------------------------------------------------------------------------------------------------------------------------------------------------------------
--------------------------------------------------------------------------------------------------------------------------------------------------------------------------------------------------------
--------------------------------------------------------------------------------------------------------------------------------------------------------------------------------------------------------
--------------------------------------------------------------------------------------------------------------------------------------------------------------------------------------------------------
-------------------------------------------------------------------------------------------------------------------------------------------------------------------------------------------------------v
------o------o----o--o-----o---------------------o-oo------o-ooo----------------oo---------------------------------o---o--o-------o---------o-------------------o-o----o----o-----------------o-o------f
------B-oo----------M-?B--o--oM-?----?M-o--oooM-M----o--B-oBB-----?----?--B---o---??------------MBM-?----------?---o-o--B--o---o--o-MB-o------------B-----oo-o--B-o-o-o-B----o------M---B------o-B-----f
------------?--M-oBo--o-----?--o----?-M------------oo?B-------o-M-M---?----BooBMoM--B-o----?o-?-o--B------oBM-o--B---BB------?o-o----B-?--B-------M-o--o----------------Bo----o----oo-o--B-------------f
-------B--o---M--------M-oM--oB---o-T----oM-T--o----o---T-o-oo--B-T----?o--B-o---o----oo-Moo-?-M--?--o-oB-B-?o---o-o-?o--??M---o--oo-----o----BT--o-----B--M-MM-o--o----oT-o---MBo?-o--o--?--o-oT?-----f
------oo-B-o-------o-o--B--o-oo-oo-oT-------|-B-?-------|---M----T|---M----o-T-----?--M---------B---oT----o------T--oMB-?-To---o----o---B--M-o-|oo---o---o?-----------o--|-M------------oo--o--?|M-----f
--------M------?-----------?--------|---B?--|B---M------|---?----||-M--------|---------------?--M----|-B---?---M?|M-------|--M---------?-TB----|-----T---B-T----T--------|-------TB----M--------|------f
m-E-E-EE-------E--E---E------EE---E-|-E-E---|--EE---E-E-|--------||---E------|E------------E---E-E---|----E----EE|----E-E-|--E---E-E-----|--E--|--E--|--E-E|-E--|E-------|--E----|---EE-E-------|EEE--EX
XXXXXXXXXXXXXXXXXXXXXXXXXXXXXXXXXXXXXXXXXXXXXXXXXXXXXXXXXXXXXXXXXXXXXXXXXXXXXXXXXXXXXXXXXXXXXXXXXXXXXXXXXXXXXXXXXXXXXXXXXXXXXXXXXXXXXXXXXXXXXXXXXXXXXXXXXXXXXXXXXXXXXXXXXXXXXXXXXXXXXXXXXXXXXXXXXXXXXXXX
