--------------------------------------------------------------------------------------------------------------------------------------------------------------------------------------------------------
--------------------------------------------------------------------------------------------------------------------------------------------------------------------------------------------------------
--------------------------------------------------------------------------------------------------------------------------------------------------------------------------------------------------------
--------------------------------------------------------------------------------------------------------------------------------------------------------------------------------------------------------
--------------------------------------------------------------------------------------------------------------------------------------------------------------------------------------------------------
--------------------------------------------------------------------------------------------------------------------------------------------------------------------------------------------------------
--------------------------------------------------------------------------------------------------------------------------------------------------------------------------------------------------------
--------------------------------------------------------------------------------------------------------------------------------------------------------------------------------------------------------
-----------o-------------o---o-----------o-o-------------------o-----o-------------o------------------------------------------o-----o------o---o-------o------------------------------o------o----------
-------------B------?-M-------o--o-----o--?-o----oo?------?-------B-------?-?--------?-o-----------?---o-M-?----?o------o-?----B--M-----?----------B---o------Boooo-Mo-----?----o----------oo-----------
-------B--?-o------BM------o?-o-M--o--------o-o-o-------o?---o--o-----o--o--B----o------o-o-M----------o----o---------o--------oo----o-------o---------o-------B-----o------Bo-----o---oB---------------
-----------------------oo-----MM-o----------B--o------o?-----T--?----M-----o-----o---M------?M------------?---------B-o------o---?--------o-----o-M--B--o-M-?---------T--o--oM--T-B-------?B------------
v-------o-oo---------o--T----------o--o--o-o-M-T---------M---|oo--o---o---oT-o---------o---o--To--B---To--oB--?--o-----B--o-o----o---M-----T--?o---o------------o----T|--B--o---|-?-----------T--o------
f--------------T----B---|----------------------|-------?-----|--?----------|--------T---------|---?---|----M------T------T-----------------|?----B---------M-------?-||---------|----------B--|--?------
f---E----------|--------|---------E----E-----E-|E---E-------E|-------------|--------|---E-----|-------|-----------|-E----|-----E-E---------|-------------------------||-----E---|-----E--E----|---------
fXXXXXXXXXXXXXXXXXXXXXXXXXXXXXXXXXXXXXXXXXXXXXXXXXXXXXXXXXXXXXXXXXXXXXXXXXXXXXXXXXXXXXXXXXXXXXXXXXXXXXXXXXXXXXXXXXXXXXXXXXXXXXXXXXXXXXXXXXXXXXXXXXXXXXXXXXXXXXXXXXXXXXXXXXXXXXXXXXXXXXXXXXXXXXXXXXXXXXXX
