--------------------------------------------------------------------------------------------------------------------------------------------------------------------------------------------------------
--------------------------------------------------------------------------------------------------------------------------------------------------------------------------------------------------------
--------------------------------------------------------------------------------------------------------------------------------------------------------------------------------------------------------
--------------------------------------------------------------------------------------------------------------------------------------------------------------------------------------------------------
--------------------------------------------------------------------------------------------------------------------------------------------------------------------------------------------------------
--------------------------------------------------------------------------------------------------------------------------------------------------------------------------------------------------------
--------------------------------------------------------------------------------------------------------------------------------------------------------------------------------------------------------
--------------------------------------------------------------------------------------------------------------------------------------------------------------------------------------------------------
--------o-----o-------oo--o-------------------------------o-----o-------------o--o---o-------ooo-----------o-----o---o----o-------o---------------o--------o------o----o--o--------------o--------------
-------B--BM----M----o-M-o------oB---o-o-B-?Mo-----------B-----------M?-----------o--?-B--o-----B-o------M--M--o---o----B-MBo---o---M-o--?---------?--M-oB--o---Bo---------BB--------o-?---------?------
------------Bo-?-B-------o------M-------o-----o---o-M--o-----o----o------oooo-----------?--------o--B--M---------M--o--------o-o--------------?----o-o-------------------o--o--M----v-----------o-------
---------o-o?--o---oo------oMo--o---o--o--T-------o-o--oB----M-M--B---M-o-o-o-------------?------B---T-o--?o-------------o------?--------------oM-----o-o-T-----MT-----------?o--B--f-----o-o-----------
--------?o-B-o-----B-------oo-oo-?T--Mo-o-|T--o-o-??----o------ooo----o-----o---o-T-----M------------|-----o---T--oo------------T---M---?-------oB--------|--?---|--------TB--------f-------o----B------
------------------------------T---|-M-----||-----------M-T--------M-------B----M--|-----T--?----M----|-------?-T-----?-B--------|--------?-M-----------BMM|--T---|--------|---------f-----M--M----------
m----E--------E---------------|-E-|------E||-------E-----|--E------E-------E-EE---|-----|------------|---------|----------------|-------E-----------E--E--|--|-E-|--------|---------f-------------------
XXXXXXXXXXXXXXXXXXXXXXXXXXXXXXXXXXXXXXXXXXXXXXXXXXXXXXXXXXXXXXXXXXXXXXXXXXXXXXXXXXXXXXXXXXXXXXXXXXXXXXXXXXXXXXXXXXXXXXXXXXXXXXXXXXXXXXXXXXXXXXXXXXXXXXXXXXXXXXXXXXXXXXXXXXXXXXXXXXXXXXXXXXXXXXXXXXXXXXXX
