--------------------------------------------------------------------------------------------------------------------------------------------------------------------------------------------------------
--------------------------------------------------------------------------------------------------------------------------------------------------------------------------------------------------------
--------------------------------------------------------------------------------------------------------------------------------------------------------------------------------------------------------
--------------------------------------------------------------------------------------------------------------------------------------------------------------------------------------------------------
--------------------------------------------------------------------------------------------------------------------------------------------------------------------------------------------------------
--------------------------------------------------------------------------------------------------------------------------------------------------------------------------------------------------------
--------------------------------------------------------------------------------------------------------------------------------------------------------------------------------------------------------
---------------------------------------------------------------------------------------------------------------------------------------------------------------------------------------------------v----
---------------------------o-----------------------------------------------------------------------------------------------------------------------------------------------------------------------f----
-----------------------------------o---------------------------------------------------------------------------------------------------------------------------------------------------------------f----
------------------------------------------------o----o---------------o----------------------------------------------------------------------------------------------------M-----------------B------f----
-------------------------------M---------------o---------------------------------------o----------B--------o---------------------------------?---------o-------------------------------o----------Bf----
---------?-----------------------------------------------------------------------------------------------M----o-o----TT--------------------------------------TT------------------------------------f----
------------------------------------------------------------------------------------------------------------------M--||--------------------------------------||------------------------------------f----
m------------------------------------------------E------E------------------------------------------------------------||------E----------------------------E--||-----------E-------------------E----X----
XXXXXXXXXXXXXXXXXXXXXXXXXXXXXXXXXXXXXXXXXXXXXXXXXXXXXXXXXXXXXXXXXXXXXXXXXXXXXXXXXXXXXXXXXXXXXXXXXXXXXXXXXXXXXXXXXXXXXXXXXXXXXXXXXXXXXXXXXXXXXXXXXXXXXXXXXXXXXXXXXXXXXXXXXXXXXXXXXXXXXXXXXXXXXXXXXXXXXXXX
