--------------------------------------------------------------------------------------------------------------------------------------------------------------------------------------------------------
--------------------------------------------------------------------------------------------------------------------------------------------------------------------------------------------------------
--------------------------------------------------------------------------------------------------------------------------------------------------------------------------------------------------------
--------------------------------------------------------------------------------------------------------------------------------------------------------------------------------------------------------
--------------------------------------------------------------------------------------------------------------------------------------------------------------------------------------------------------
--------------------------------------------------------------------------------------------------------------------------------------------------------------------------------------------------------
--------------------------------------------------------------------------------------------------------------------------------------------------------------------------------------------------------
-------------------------------------------------------------------------------------------------------------------------------------------------------------------------------------------------------v
-------o--------------o----ooo--o-------oo-o-o----o------------------o-o-o----------o--------o----o--o-o-------o-o--------o--o------o-o-o-------o-----------o-o--oo--o----o---o---o------o--oo-o-------f
------?-------o--BMoo-M-Bo---?-oo???o------o?o-B-B--oB-----o-B-o----B?-B-oo-o----Bo---?-o--Bo-----B-o---?----Mo-M-------o--?--o-----o-?o-?ooo-B---M--------B-o--?o-M--?oooMo??Bo----?BM?----o---BM-----f
------ooo-o-oo---?-?--?--M--oo------Mo-------oB-o--B---o-B-B-Boo-oo---o------oM----oo--o---M---oooB?----?-M--o?MoBB-?------oM----MM-?----Mo----MB--oo?-B--oMoo--ooMo-o----M-o-M-o-o-?M-------oo-B------f
-------oo-----oMT-o-M--o-oT----?o-----M?M--o------oT-o--B--oT-o----MooB-o-o?--o-?-------o---B--M--------o--oo-T-M--o-oM----o-?-TM--??-----T-?--ooo---Mo-oo----?---M---o--o--M-Boooo-------MoM-?-T------f
------o---B--ooT|--o---o--|To----o--M---M---B-oMoB-|-Bo-M-oMT-o------Mo-?-ooMo-oB--?-o---TB---ooooBo--B--T----|----ooTo-oo--ooo|---?---B-o|-oM---o-?MM----M--M-o-----o-oB-oBM---?oM------o?-Bo-o|------f
-------------?-||---?-----||-----M--T-B----M-------|---?BM--|-----?-M?T-?---T-------T----|----------M--M-|-B--|--?---|------MMM|--M-B-----|-M-----?---------T-B--T-M--TMT-M------B----?--M------|M-----f
mEE-EE-E-E---EE||E--E----E||----E---|-E---EE---EE--|--------|--EE----E|-E---|-------|----|---------------|----|---E--|---------|----------|-----------------|-E-E|E--E|-|-----------------------|------X
XXXXXXXXXXXXXXXXXXXXXXXXXXXXXXXXXXXXXXXXXXXXXXXXXXXXXXXXXXXXXXXXXXXXXXXXXXXXXXXXXXXXXXXXXXXXXXXXXXXXXXXXXXXXXXXXXXXXXXXXXXXXXXXXXXXXXXXXXXXXXXXXXXXXXXXXXXXXXXXXXXXXXXXXXXXXXXXXXXXXXXXXXXXXXXXXXXXXXXXX
