--------------------------------------------------------------------------------------------------------------------------------------------------------------------------------------------------------
--------------------------------------------------------------------------------------------------------------------------------------------------------------------------------------------------------
--------------------------------------------------------------------------------------------------------------------------------------------------------------------------------------------------------
--------------------------------------------------------------------------------------------------------------------------------------------------------------------------------------------------------
--------------------------------------------------------------------------------------------------------------------------------------------------------------------------------------------------------
--------------------------------------------------------------------------------------------------------------------------------------------------------------------------------------------------------
--------------------------------------------------------------------------------------------------------------------------------------------------------------------------------------------------------
-------------------------------------------------------------------------------------------------------------------------------------------------------------------------------------------------------v
--------B-----------------------o------------------------------------------------B-B?---------o-------------------------------------------------X--B----------?BBB?-----------------------B------------f
--------------------------------------------X-B----o---------?B?--BBBBB?-M-??BB?--------------------------------------??M---?B??-----------------------------------------------B?----------------------f
------o-------o------o-o-------------?B?B?BB---------?BB--M?-------------------------------o----------------------------o-----o---------BB--?--------------------------------o------X-------?-BB?------f
---------------------------o--T------------------T-------To---------------o--MBBBB-B---------------X----------X----?----------------------oT--B-?B--X---M-X---o----X------T----------------------------f
-------------------B----------|----------?B???---|-------|---------------o-------------------o---T-XX----M?--XX--------BB-B?------BBBT--M?o|-o-----?XX--------------------|---X--------T----o----------f
-------------T---T-----------o|---T--T-----------|-------|----------o-T--------------------------|-XXXo-----XXX----------------------|-----|----o---XXX-------------------|------------|---------------f
m-E----------|---|------------|--E|--|-----------|-------|------------|--------------------------|-XXXX----XXXX-----------E----------|--XX-|--------XXXX------------------|------------|--------------XX
XXXXXXXXXXXXXXXXXXXXXXXXXXXXXXXXXXXXXXXXXXXXXXXXXXXXXXXXXXXXXXXXXXXXXXXXXXXXXXXXXXXXXXXXXXXXXXXXXXXXXXXXXXXXXXXXXXXXXXXXXXXXXXXXXXXXXXXXXXXXXXXXXXXXXXXXXXXXXXXXXXXXXXXXXXXXXXXXXXXXXXXXXXXXXXXXXXXXXXXX
