--------------------------------------------------------------------------------------------------------------------------------------------------------------------------------------------------------
--------------------------------------------------------------------------------------------------------------------------------------------------------------------------------------------------------
--------------------------------------------------------------------------------------------------------------------------------------------------------------------------------------------------------
--------------------------------------------------------------------------------------------------------------------------------------------------------------------------------------------------------
--------------------------------------------------------------------------------------------------------------------------------------------------------------------------------------------------------
--------------------------------------------------------------------------------------------------------------------------------------------------------------------------------------------------------
--------------------------------------------------------------------------------------------------------------------------------------------------------------------------------------------------------
-------------------------------------------------------------------------------------------------------------------------------------------------------------------------------------------------------v
------------o------o---------o-----------o-----------o--------o-------------o--oo--o-o---------------oo----oo-----o------o-o---o--o----oo---o----------------o-----------------------------------------f
-------o-B---o--B-------?--oo--o-?----o-?o----------?--?-------B?o---o-----B--o---B--BB------o-?MB--o-ooo----------B-----------?--M-B-o-------M?o-------o-M---?-----B--------------------?-B-----------f
--------?----------------------o---oo-o--B-o--------------------------------o----?---B--M---M---?-?--o-----------o-M?M--B-------------------?--------o---o--o--Boo--o----------B--Mo----------B-oM-----f
---------o--M-------T--B--------------------o---?oo--oo-To--o---------Mo---o-------------M-o------o-B-----oM---o?B-----oo--T------oo--T-------------o--o--B-o--T----o----------o-T-----T-------o-------f
---------oM----o--Mo|---To-B---B-o---B--o---oTo--?To----|-------o------To--o------B-------o---?-----o-TM-B----T----oo------|o-B-oooo-T|-----------M------oo--B-|---o------??--ooM|M----|------o--------f
--------------------|-B-|--------------------|M---|---?-|--------------|------------T-T---M-----T-----|-------|---B--B-T--M|--?------||-MT--T------------M-----|-----------------|B----|---------------f
m----E--EEEE--E-----|---|---EE----E--E--E-E--|----|E--E-|---E-E--------|------E-EEEE|-|E---EE---|-----|EE-----|-------E|---|---E--E--||E-|-E|-----------------E|-------E-----E--E|-----|-EE--EE--E-----X
XXXXXXXXXXXXXXXXXXXXXXXXXXXXXXXXXXXXXXXXXXXXXXXXXXXXXXXXXXXXXXXXXXXXXXXXXXXXXXXXXXXXXXXXXXXXXXXXXXXXXXXXXXXXXXXXXXXXXXXXXXXXXXXXXXXXXXXXXXXXXXXXXXXXXXXXXXXXXXXXXXXXXXXXXXXXXXXXXXXXXXXXXXXXXXXXXXXXXXXX
