T?X------------------------BMBTE---------------------------BE------------------------------------------------------------------------------------X------------?----------TXE---------------------------|
MTo------------------------|BBBMo---------------------------X------------------------------------------------------------------------------------?----------XXT----------oX|---------------------------T
oE-------------------------EET?MB--------------------------T-------------------------------------------------------------------------------------?----------ME|----------oM|---------------------------B
X-B------------------------|-|B|B---------------------------M------------------------------------------------------------------------------------M----------B-E----------|?M---------------------------o
T|M------------------------TBo?|?--------------------------Bo------------------------------------------------------------------------------------E----------M?-----------|-|---------------------------|
-Xo------------------------?TXETX--------------------------M-------------------------------------------------------------------------------------M----------ToM----------ooX---------------------------o
oXo------------------------Eo?X?T--------------------------TM------------------------------------------------------------------------------------X----------|TB----------XM----------------------------B
EMM------------------------T|EM----------------------------MB------------------------------------------------------------------------------------o----------oTM----------?T?---------------------------v
ETE------------------------MEE?M|--------------------------BM------------------------------------------------------------------------------------E----------B|o----------BX|---------------------------?
T|M------------------------||M-|?--------------------------oM------------------------------------------------------------------------------------T----------?TE----------B|E---------------------------o
BoE------------------------MBEoXo--------------------------XT------------------------------------------------------------------------------------X----------Eo?----------??B---------------------------M
-XT------------------------TMBM?---------------------------oT------------------------------------------------------------------------------------|----------T-X----------E-o------------------XXXXXXXXXM
?o-------------------------B?||TX--------------------------oM------------------------------------------------------------------------------------M----------XXT----------M-?------------------XXXXXXXXXB
oTo------------------------XoMM|---------------------------?|------------------------------------------------------------------------------------|----------oT|----------?|-------------------XXXXXXXXXM
mBM-------------------------|?-||--------------------------BM-----------------------------------------------------------------------------------------------B-M----------TMB------------------XXXXXXXXX-
XXXXXXXXXXXXXXXXXXXXXXXXXXXXXXXXXXXXXXXXXXXXXXXXXXXXXXXXXXXXXXXXXXXXXXXXXXXXXXXXXXXXXXXXXXXXXXXXXXXXXXXXXXXXXXXXXXXXXXXXXXXXXXXXXXXXXXXXXXXXXXXXXXXXXXXXXXXXXXXXXXXXXXXXXXXXXXXXXXXXXXXXXXXXXXXXXXXXXXXX
