--------------------------------------------------------------------------------------------------------------------------------------------------------------------------------------------------------
--------------------------------------------------------------------------------------------------------------------------------------------------------------------------------------------------------
--------------------------------------------------------------------------------------------------------------------------------------------------------------------------------------------------------
--------------------------------------------------------------------------------------------------------------------------------------------------------------------------------------------------------
--------------------------------------------------------------------------------------------------------------------------------------------------------------------------------------------------------
--------------------------------------------------------------------------------------------------------------------------------------------------------------------------------------------------------
--------------------------------------------------------------------------------------------------------------------------------------------------------------------------------------------------------
---------------------------------------------------------------------------------------------------------------------------------------------------------------------------------------------------v----
-----------------------------------------------------------------------------------------------------------------------------------o---------------------------------------------------------------f----
-----------------------------------------------------------------------------------------o-------o-------------------------------------------------------------------------------------------------f----
---------------o------------------------------B------------------------------------------------------------------B------o-------------------o---------o-------?----------------------------o-----B-f----
------------------------------------------------------M----------o---------------------o--------B------------------------------M------------------o------------------------------------------------f----
---?---------------------------------------------------------------------------------------o-------------------------------------o--------------------------------o----------------------?---------f----
------------------TT-----------------M-------------------------------------------------------------------TTM---------------------------------------------------------------------------------------f----
m--E---------E----||-------------------------E--------------------------------E--------------------------||---E---------------------------------------------------------E--------------------------X----
XXXXXXXXXXXXXXXXXXXXXXXXXXXXXXXXXXXXXXXXXXXXXXXXXXXXXXXXXXXXXXXXXXXXXXXXXXXXXXXXXXXXXXXXXXXXXXXXXXXXXXXXXXXXXXXXXXXXXXXXXXXXXXXXXXXXXXXXXXXXXXXXXXXXXXXXXXXXXXXXXXXXXXXXXXXXXXXXXXXXXXXXXXXXXXXXXXXXXXXX
