--------------------------------------------------------------------------------------------------------------------------------------------------------------------------------------------------------
--------------------------------------------------------------------------------------------------------------------------------------------------------------------------------------------------------
--------------------------------------------------------------------------------------------------------------------------------------------------------------------------------------------------------
--------------------------------------------------------------------------------------------------------------------------------------------------------------------------------------------------------
--------------------------------------------------------------------------------------------------------------------------------------------------------------------------------------------------------
--------------------------------------------------------------------------------------------------------------------------------------------------------------------------------------------------------
--------------------------------------------------------------------------------------------------------------------------------------------------------------------------------------------------------
--------------------------------------------------------------------------------------------------------------------------------------------------------------------------------------------------------
-------o----o---o-----------o--oo--o--o--o-------oo---o-----------o----------------o-----o------o-------------------o--o----------o---o---o--------------------------o----o---------------------o-------
---------B-o--M?----?--B----oM----?------o--BMo--o--B-o-o------o-B--o-o-?-o---o-o-o---------oo----M---?-------B----M--M-?-----B--B-----?----o----?------?-----------?o--B---o-M----M---o-?o-o----o------
-------M-----Mo-------o----o--------B--------o-o-------?----o-o-------o-o-------Bo--------M-oB----o----o----Mo---o---?---o----B------o-?-B---------o-o?----o--o-o----?Mo----o?------o------------B------
---------M------o-o----?-ooM---o-o------?---------------M-TB----o-Mooo------o--o-o------o--M--o--o--o-To-----o-o-o--T-o-M-----------------oB----o-o------o---?-o---T--o?--o---ooM-------?-o---T---------
-----------M--??-?--o----?--MM--T-?BM-B----??------oo--M--|To-o------oo--o----o-oo--oB-----T--o?oo-o--|---B-o-oo-Boo|-----------o------B----T--B-----Bv-----o--o-BM|--T-oo-------o-o----o-ooo-|---------
--------B-?---------------------|---B---------?-T---------||--T----T-----?--BT-B------T---M|-------M-B|--M-----?----|------T------B---------|-T-------f--M---------|?-|----?--B--M------------|---------
m------E------------------------|------------E--|----E----||--|----|------E--|--------|---E|----------|-------------|------|------E------E--|-|E------f----------E-|--|E------------------E---|EE--E----
XXXXXXXXXXXXXXXXXXXXXXXXXXXXXXXXXXXXXXXXXXXXXXXXXXXXXXXXXXXXXXXXXXXXXXXXXXXXXXXXXXXXXXXXXXXXXXXXXXXXXXXXXXXXXXXXXXXXXXXXXXXXXXXXXXXXXXXXXXXXXXXXXXXXXXXXXXXXXXXXXXXXXXXXXXXXXXXXXXXXXXXXXXXXXXXXXXXXXXXX
