--------------------------------------------------------------------------------------------------------------------------------------------------------------------------------------------------------
--------------------------------------------------------------------------------------------------------------------------------------------------------------------------------------------------------
--------------------------------------------------------------------------------------------------------------------------------------------------------------------------------------------------------
--------------------------------------------------------------------------------------------------------------------------------------------------------------------------------------------------------
--------------------------------------------------------------------------------------------------------------------------------------------------------------------------------------------------------
--------------------------------------------------------------------------------------------------------------------------------------------------------------------------------------------------------
--------------------------------------------------------------------------------------------------------------------------------------------------------------------------------------------------------
-------------------------------------------------------------------------------------------------------------------------------------------------------------------------------------------------------v
---------o----o-----o------oooo---------oo---o-o---------o--o-o-oo----o----------o------oo----------------o----o---o-----o-----o-----o-------o-----------o-o-----o-----o--o-------o----------oo-o------f
------B--o-Bo---M----M---M-o?-o--o?o----?o-o--M--?---o---M--?-----Bo--o--?o-----Mo?-----------?o----o-B-oo----?---M--BM-M-?---M-oo--?---o--B---oo-o----B-----?--ooo--o----?----B---oM----o-Bo-Bo-------f
--------------------B--M--?--------Bo-o---B-------M--o---B----?-o--?------M--o--B--B-------B------oo--oo-oBB---oo-o-o--o?--?-o?--MBo--ooBMo----o-o--o---o------o-?------B--B-oo------------------------f
-------B--o--oB-----------oo-oB------M---o--MBTM-----Bo--T--T----o--o--?B-MMM------B--o--o-MTMo-B----o-----o-M-----o--B-?M---MT--o-?--B--o----B?oo--oM--B-?o----o-----o?-o--T-ooo-MB------?--oM--------f
------B--B-o-o--B-To--o-B--M-T---?--oB--?-----|-?-------M|-o|-----B---------?B?o---?oo-----?|--M---T-M--M?-oMo-B?o-MBMB----B-B|-----o-M-o----ooT--B--B---?------o-o--?--o---|--?-Bo-MoM--o--o--ToM-----f
--------M---?-B---|--B---B---|-M---T-----?----|--T------B|--|M---M--B-?---B------?---------B|--M?--|---B-------T-----------M-B|------------B---|-?--T----------------?---M-?|----BTM--------M?-|-------f
m-E-EE-EE-------EE|-E--E-EE--|-----|----------|E-|-E---E-|-E|--E-E----E-E-------E-EEE-EEE---|-----E|--EE-----E-|------------EE|E-E-E------EE---|----|---EE-E-E--------E-E---|E----|----EE---E--|-EE--EEX
XXXXXXXXXXXXXXXXXXXXXXXXXXXXXXXXXXXXXXXXXXXXXXXXXXXXXXXXXXXXXXXXXXXXXXXXXXXXXXXXXXXXXXXXXXXXXXXXXXXXXXXXXXXXXXXXXXXXXXXXXXXXXXXXXXXXXXXXXXXXXXXXXXXXXXXXXXXXXXXXXXXXXXXXXXXXXXXXXXXXXXXXXXXXXXXXXXXXXXXX
