--------------------------------------------------------------------------------------------------------------------------------------------------------------------------------------------------------
--------------------------------------------------------------------------------------------------------------------------------------------------------------------------------------------------------
--------------------------------------------------------------------------------------------------------------------------------------------------------------------------------------------------------
--------------------------------------------------------------------------------------------------------------------------------------------------------------------------------------------------------
--------------------------------------------------------------------------------------------------------------------------------------------------------------------------------------------------------
--------------------------------------------------------------------------------------------------------------------------------------------------------------------------------------------------------
--------------------------------------------------------------------------------------------------------------------------------------------------------------------------------------------------------
-------------------------------------------------------------------------------------------------------------------------------------------------------------------------------------------------------v
----------o--------o-----------o--------o-------------------o-------o-------o-o-o------oo--o--oo--------------oo-oo----o-----o-----o--------------------------o----oo--------------------o---o--oo-----f
-------o-?--------B--?-o------BB----B-o----MoB-------?---?-------o-?------o-oB--------?--o--M--------------BMo---B-o--?----Mo--M-M--?----?----MMooo-----o-?o---?-B--M---?----M---?---------B----B------f
------------o-?--o----?--o---o-o-o-------o-------M------------o-o-----o--M-----Moo---B?-o-Mo-----ooo-o---o--o-o-o----ooo---o---o---?---o-----------o----o---o---?-B--B-B------------------o-M-B--------f
------o---?o----?-?----M-?T-??---?-B-o-----o-?--M---T-B---?---o---oo?B------B---------B------BT?------M-B-M-oo-oM---M----T---?-o-BM-----o--To---Too-----MB-o-oo--o-----?---ooo----T---------oo---------f
--------oT--M--B----------|--o--o-o-----o-T?-----?--|---------o----T---T------oMo-------o----M|--------?B---M----o-o-----|o----------------|-M--|------M----o--MT-M--B--------B---|-Bo----o--B-T-?-----f
---------|----------------|--?-------M----|---?----B|----MM--B-----|---|---T---?--------------|--B---------?M--M--MTM----|B-MM-----M-B-----|B---|---BT-------T--|-------M-B--B----|------------|-------f
m-----E--|---E-E----E--E--|-------E--E----|---------|--------EE--E-|-E-|-E-|-----------EE-----|-------E-E--------E-|E---E|----EEE----EE---E|----|----|----E-E|--|--E--------------|-E--E-------|---E---X
XXXXXXXXXXXXXXXXXXXXXXXXXXXXXXXXXXXXXXXXXXXXXXXXXXXXXXXXXXXXXXXXXXXXXXXXXXXXXXXXXXXXXXXXXXXXXXXXXXXXXXXXXXXXXXXXXXXXXXXXXXXXXXXXXXXXXXXXXXXXXXXXXXXXXXXXXXXXXXXXXXXXXXXXXXXXXXXXXXXXXXXXXXXXXXXXXXXXXXXX
