--------------------------------------------------------------------------------------------------------------------------------------------------------------------------------------------------------
--------------------------------------------------------------------------------------------------------------------------------------------------------------------------------------------------------
--------------------------------------------------------------------------------------------------------------------------------------------------------------------------------------------------------
--------------------------------------------------------------------------------------------------------------------------------------------------------------------------------------------------------
--------------------------------------------------------------------------------------------------------------------------------------------------------------------------------------------------------
--------------------------------------------------------------------------------------------------------------------------------------------------------------------------------------------------------
--------------------------------------------------------------------------------------------------------------------------------------------------------------------------------------------------------
--------------------------------------------------------------------------------------------------------------------------------------------------------------------------------------------------------
--------------------------------------------------------------------------------------------------------------------------------------------------------------------------------------------------------
--------------------------------------------------------------------------------------------------------------------------------------------------------------------------------------------------------
---------------?--------------------------------------------------------------------------------------------------------------------------------------------------------------------------------------v-
------------------T----------------------------------------T-----B------T---------------T-------T--------T-------------B------------------------T--------------------T-----------------------T--------f-
------------------|---------------T------------------------|------------|-------T-------|-------|--------|---------------------T----------------|---?---?------------|----------B------------|--------f-
------------------|---------------|------------------------|------------|-------|-------|-------|--------|---------------------|----------------|----o---------------|-----------------------|--------f-
-m----------------|---------------|------------------------|------------|-------|-------|-------|--------|---------------------|----------E-----|--------------------|---------E-------------|--------f-
XXXXXXXXXXXXXXXXXXXXXXXXXXXXXXXXXXXXXXXXXXXXXXXXXXXXXXXXXXXXXXXXXXXXXXXXXXXXXXXXXXXXXXXXXXXXXXXXXXXXXXXXXXXXXXXXXXXXXXXXXXXXXXXXXXXXXXXXXXXXXXXXXXXXXXXXXXXXXXXXXXXXXXXXXXXXXXXXXXXXXXXXXXXXXXXXXXXXXXXX
