--------------------------------------------------------------------------------------------------------------------------------------------------------------------------------------------------------
--------------------------------------------------------------------------------------------------------------------------------------------------------------------------------------------------------
--------------------------------------------------------------------------------------------------------------------------------------------------------------------------------------------------------
--------------------------------------------------------------------------------------------------------------------------------------------------------------------------------------------------------
--------------------------------------------------------------------------------------------------------------------------------------------------------------------------------------------------------
--------------------------------------------------------------------------------------------------------------------------------------------------------------------------------------------------------
--------------------------------------------------------------------------------------------------------------------------------------------------------------------------------------------------------
--------------------------------------------------------------------------------------------------------------------------------------------------------------------------------------------------------
--------------------------------------------------------------------------------------------------------------------------------------------------------------------------------------------------------
--------------------------------------------------------------------------------------------------------------------------------------------------------------------------------------------------------
-------B-------?--------------?----B-------B--------------------B-----------?---------B-------------------B----------o--------?-----------?------------------------B-------------?--------Bo----------v-
-----T--?---------T---?---------------T-?-----------B---B-oT-----B------T---------------T--o----T--------T-------?-?-----------T-------?--------T------B-------------T?----------------?-----T--------f-
-----|-?----------|B-B------------T---|--------------------|-------?----|-------T-------|-B-----|--o-----|----B-------?--------|----------------|---?---?o-----------|-?--------B--o--------?|----B---f-
--B--|------------|---------------|---|--------------------|------------|-------|---?---|-------|--------|---------------------|--------?-------|----o-----------B---|--?-----------------?--|-----B--f-
-m---|------------|---------------|---|----E---------E-----|------E-----|-------|-------|-------|--------|----------E----------|----------E-----|-------------E------|---------E-------------|--------f-
XXXXXXXXXXXXXXXXXXXXXXXXXXXXXXXXXXXXXXXXXXXXXXXXXXXXXXXXXXXXXXXXXXXXXXXXXXXXXXXXXXXXXXXXXXXXXXXXXXXXXXXXXXXXXXXXXXXXXXXXXXXXXXXXXXXXXXXXXXXXXXXXXXXXXXXXXXXXXXXXXXXXXXXXXXXXXXXXXXXXXXXXXXXXXXXXXXXXXXXX
