--------------------------------------------------------------------------------------------------------------------------------------------------------------------------------------------------------
--------------------------------------------------------------------------------------------------------------------------------------------------------------------------------------------------------
--------------------------------------------------------------------------------------------------------------------------------------------------------------------------------------------------------
--------------------------------------------------------------------------------------------------------------------------------------------------------------------------------------------------------
--------------------------------------------------------------------------------------------------------------------------------------------------------------------------------------------------------
--------------------------------------------------------------------------------------------------------------------------------------------------------------------------------------------------------
--------------------------------------------------------------------------------------------------------------------------------------------------------------------------------------------------------
--------------------------------------------------------------------------------------------------------------------------------------------------------------------------------------------------------
--------------------------------------------------------------------------------------------------------------------------------------------------------------------------------------------------------
--------------------------------------------------------------------------------------------------------------------------------------------------------------------------------------------------------
-------B-------?-------------------?o-------------?------------?------------?-----------------------------B----------o--------?---------??---------------------------------------?--------Bo------?--ov-
-----T--?---------T-------T-----------T----------------o---T-----B--o---T---------------T-------T--------T-------?-------------T-------o------T---------T------------T-----------------------T------?-f-
-----|------------|B-B----|-----------|--------------------|-----------o|-------T-------|-------|--------|----B-------?------o-|--------?-----|---o---?-|-----------o|-?--o-----B--oo--------|--------f-
--B--|---?--------|----B--|---B-------|--------------------|------?-----|-------|-------|-------|--------|----------------o----|-?----------?-|---------|------------|--------------------?--|--------f-
-m---|------------|-------|-----------|----E---------------|------------|-------|-------|-------|--------|----------E----------|------------E-|---------|------------|---------E-------------|--------f-
XXXXXXXXXXXXXXXXXXXXXXXXXXXXXXXXXXXXXXXXXXXXXXXXXXXXXXXXXXXXXXXXXXXXXXXXXXXXXXXXXXXXXXXXXXXXXXXXXXXXXXXXXXXXXXXXXXXXXXXXXXXXXXXXXXXXXXXXXXXXXXXXXXXXXXXXXXXXXXXXXXXXXXXXXXXXXXXXXXXXXXXXXXXXXXXXXXXXXXXX
