--------------------------------------------------------------------------------------------------------------------------------------------------------------------------------------------------------
--------------------------------------------------------------------------------------------------------------------------------------------------------------------------------------------------------
--------------------------------------------------------------------------------------------------------------------------------------------------------------------------------------------------------
--------------------------------------------------------------------------------------------------------------------------------------------------------------------------------------------------------
--------------------------------------------------------------------------------------------------------------------------------------------------------------------------------------------------------
--------------------------------------------------------------------------------------------------------------------------------------------------------------------------------------------------------
--------------------------------------------------------------------------------------------------------------------------------------------------------------------------------------------------------
--------------------------------------------------------------------------------------------------------------------------------------------------------------------------------------------------------
--------------------------------------------------------------------------------------------------------------------------------------------------------------------------------------------------------
--------------------------------------------------------------------------------------------------------------------------------------------------------------------------------------------------------
--?--?-o-------?-------------------?----------------?-------------o----o-----o-B--?------------------B--------------oB-----B------B------------?---------------------------------?----B---Bo----?-?---v-
----------T-------T-------T-----------T-------?----B------B-----?-------T---------------T-------T--------T---o---------B-B--------------------T---------T------------T-----------------------T--------f-
--------B-|-------|B-B----|-----------|-----------------------------T---|-------T-----o-|-------|--------|-----------------?---T------o-------|-------?-|-----------o|-?--------B--oo--------|--------f-
----------|-------|----B--|---B-------|----------?---o---------?----|---|-------|----?--|o------|--------|---------------------|------------?-|---------|---B--------|--------------------?--|--------f-
-m--------|-------|-------|-----------|----E------------------------|---|E------|-------|-------|E-------|------------E--------|-E--------E---|---------|-----E------|---------E-------------|--------f-
XXXXXXXXXXXXXXXXXXXXXXXXXXXXXXXXXXXXXXXXXXXXXXXXXXXXXXXXXXXXXXXXXXXXXXXXXXXXXXXXXXXXXXXXXXXXXXXXXXXXXXXXXXXXXXXXXXXXXXXXXXXXXXXXXXXXXXXXXXXXXXXXXXXXXXXXXXXXXXXXXXXXXXXXXXXXXXXXXXXXXXXXXXXXXXXXXXXXXXXX
