--------------------------------------------------------------------------------------------------------------------------------------------------------------------------------------------------------
--------------------------------------------------------------------------------------------------------------------------------------------------------------------------------------------------------
--------------------------------------------------------------------------------------------------------------------------------------------------------------------------------------------------------
--------------------------------------------------------------------------------------------------------------------------------------------------------------------------------------------------------
--------------------------------------------------------------------------------------------------------------------------------------------------------------------------------------------------------
--------------------------------------------------------------------------------------------------------------------------------------------------------------------------------------------------------
--------------------------------------------------------------------------------------------------------------------------------------------------------------------------------------------------------
--------------------------------------------------------------------------------------------------------------------------------------------------------------------------------------------------------
--------------------------------------------------------------------------------------------------------------------------------------------------------------------------------------------------------
--------------------------------------------------------------------------------------------------------------------------------------------------------------------------------------------------------
-------B-------?-------------------?--------------?---------------o---------?---------------------------B-B----------o--------?---------??-----------------?---------------------?--------Bo---------?v-
-----T--?---------T-------T-----------T----------------o---T-----B--o---T---------------T-------T--------T-------?-------------T-------o------T---------T------------T-----------------?-----T--?-----f-
-----|-?----------|B-B----|-----------|--------------------|------------|-------T-------|-------|--------|----B-------?------o-|--------?-----|---o---??|-----------o|-?--o-----B--o--------?|--------f-
--B--|------------|----B--|---B-------|--------------------|------?-----|-------|-------|-------|--------|----------------o----|-?----------?-|---------|------------|--------------------?--|-----?--f-
-m---|------------|-------|-----------|----E---------------|------------|-------|-------|-------|--------|----------E----------|------------E-|---------|------------|---------E-------------|--------f-
XXXXXXXXXXXXXXXXXXXXXXXXXXXXXXXXXXXXXXXXXXXXXXXXXXXXXXXXXXXXXXXXXXXXXXXXXXXXXXXXXXXXXXXXXXXXXXXXXXXXXXXXXXXXXXXXXXXXXXXXXXXXXXXXXXXXXXXXXXXXXXXXXXXXXXXXXXXXXXXXXXXXXXXXXXXXXXXXXXXXXXXXXXXXXXXXXXXXXXXX
