--------------------------------------------------------------------------------------------------------------------------------------------------------------------------------------------------------
--------------------------------------------------------------------------------------------------------------------------------------------------------------------------------------------------------
--------------------------------------------------------------------------------------------------------------------------------------------------------------------------------------------------------
--------------------------------------------------------------------------------------------------------------------------------------------------------------------------------------------------------
--------------------------------------------------------------------------------------------------------------------------------------------------------------------------------------------------------
--------------------------------------------------------------------------------------------------------------------------------------------------------------------------------------------------------
--------------------------------------------------------------------------------------------------------------------------------------------------------------------------------------------------------
--------------------------------------------------------------------------------------------------------------------------------------------------------------------------------------------------------
--------------------------------------------------------------------------------------------------------------------------------------------------------------------------------------------------------
--------------------------------------------------------------------------------------------------------------------------------------------------------------------------------------------------------
-------B-------?---?--------?----?-?o------B--------?-----------B-----------?-?-?-----------B-------------B---B---o-?o-----Bo-?-?--------?-B-------B---B-----------------B-------?---B----BoB-----?---v-
-----T--?----oo---T---o---T-----------T-?---------------B-oT---?-B------T---------------T-------T----o---T-------?-------o-----T----o--o--o---T---------T----------?-T-----------------------T-o------f-
-----|-?----------|B-B----|---------?-|----------------?---|------------|-------To------|---?---|--------|----B-------?------o-|--------?-----|---o---?-|-----------o|-?-------?B--o---------|--?-o--of-
--B--|---B--?-----|----B--|--oB-------|---B-B--------------|------------|-o-----|-------|B------|------?-|----------------oo---|-?--o-------?-|---------|------------|--------------------?--|B-------f-
-m---|------------|-------|-----------|----E---------E-----|------E-----|E------|-------|----E--|-----E--|-----E----E----------|------E-----E-|---------|------------|---------E-------------|-E------f-
XXXXXXXXXXXXXXXXXXXXXXXXXXXXXXXXXXXXXXXXXXXXXXXXXXXXXXXXXXXXXXXXXXXXXXXXXXXXXXXXXXXXXXXXXXXXXXXXXXXXXXXXXXXXXXXXXXXXXXXXXXXXXXXXXXXXXXXXXXXXXXXXXXXXXXXXXXXXXXXXXXXXXXXXXXXXXXXXXXXXXXXXXXXXXXXXXXXXXXXX
