--------------------------------------------------------------------------------------------------------------------------------------------------------------------------------------------------------
--------------------------------------------------------------------------------------------------------------------------------------------------------------------------------------------------------
--------------------------------------------------------------------------------------------------------------------------------------------------------------------------------------------------------
--------------------------------------------------------------------------------------------------------------------------------------------------------------------------------------------------------
--------------------------------------------------------------------------------------------------------------------------------------------------------------------------------------------------------
--------------------------------------------------------------------------------------------------------------------------------------------------------------------------------------------------------
--------------------------------------------------------------------------------------------------------------------------------------------------------------------------------------------------------
--------------------------------------------------------------------------------------------------------------------------------------------------------------------------------------------------------
--------------------------------------------------------------------------------------------------------------------------------------------------------------------------------------------------------
--------------------------------------------------------------------------------------------------------------------------------------------------------------------------------------------------------
-------B-------?---?--------?----?-?o-------------?------------?-------o----?-----?B--------B----?--------B---B-o-o--o-----B--?-------?-??--?--------------?----------?----------?--------BoB-----?---v-
-----T--?---?-o---T-------T-----------T----------?-----o---To----B--o---T-o-------------T-------T----o---T-------?-------o-----T-------o------T---------T----------?-T-----------------------T-------of-
-----|-?----------|B-B----|B--------?-|----o-------------?B|------------|-------T-------|-------|--------|----B------o?------o-|------B-?-----|---o---??|-------o---o|-?--o-----B--o---------|--?-o---f-
--B--|---------?--|-?--B-?|--oB-------|--------------------|------?-o---|-------|-------|-----B-|--------|---------------?oo---|-?--?-------?-|---------|------------|o-----B-------------?--|B------?f-
-m---|------------|-------|E----------|----E---------------|------------|----E--|-------|----E--|-------E|-----E----E----------|------------E-|-----E---|------------|---------E-------------|-E------f-
XXXXXXXXXXXXXXXXXXXXXXXXXXXXXXXXXXXXXXXXXXXXXXXXXXXXXXXXXXXXXXXXXXXXXXXXXXXXXXXXXXXXXXXXXXXXXXXXXXXXXXXXXXXXXXXXXXXXXXXXXXXXXXXXXXXXXXXXXXXXXXXXXXXXXXXXXXXXXXXXXXXXXXXXXXXXXXXXXXXXXXXXXXXXXXXXXXXXXXXX
