--------------------------------------------------------------------------------------------------------------------------------------------------------------------------------------------------------
--------------------------------------------------------------------------------------------------------------------------------------------------------------------------------------------------------
--------------------------------------------------------------------------------------------------------------------------------------------------------------------------------------------------------
--------------------------------------------------------------------------------------------------------------------------------------------------------------------------------------------------------
--------------------------------------------------------------------------------------------------------------------------------------------------------------------------------------------------------
--------------------------------------------------------------------------------------------------------------------------------------------------------------------------------------------------------
--------------------------------------------------------------------------------------------------------------------------------------------------------------------------------------------------------
--------------------------------------------------------------------------------------------------------------------------------------------------------------------------------------------------------
--------------------------------------------------------------------------------------------------------------------------------------------------------------------------------------------------------
--------------------------------------------------------------------------------------------------------------------------------------------------------------------------------------------------------
-------B-?-----?---?--------?----?-B-------B--------------------B-----------?---------B----------?--------B---B-o-o--o-----B--?---------??--?--------------?----------?--------o-?-----B--BoB-----?---v-
-----T--?----oo---T-------T-----------T-?-----------B-?-B-oT-----B------T-o--------o----T--o----T-B--o---T-------?-------o-----T-------o------T---------T----------?-T--------------?--------T--------f-
-----|-?----------|B-B----|-------T---|---------B--------B-|-------?----|-------T-------|-B-----|--o-----|----B------o?------o-|------B-?-----|---o---??|-------o---o|-?--o-----B--o--------?|--?-o---f-
--B--|------------|----B--|--oB?--|---|?-----?-------------|------------|-------|---?---|-------|--------|---------------?oo---|-?--?-------?-|---------|------------|o-----B------------??--|B------?f-
-m---|------------|-------|-------|---|----E---------E-----|------E-----|---E---|-------|-------|--------|-E---E----E----------|------------E-|-----E---|------------|---------E-------------|-E------f-
XXXXXXXXXXXXXXXXXXXXXXXXXXXXXXXXXXXXXXXXXXXXXXXXXXXXXXXXXXXXXXXXXXXXXXXXXXXXXXXXXXXXXXXXXXXXXXXXXXXXXXXXXXXXXXXXXXXXXXXXXXXXXXXXXXXXXXXXXXXXXXXXXXXXXXXXXXXXXXXXXXXXXXXXXXXXXXXXXXXXXXXXXXXXXXXXXXXXXXXX
