--------------------------------------------------------------------------------------------------------------------------------------------------------------------------------------------------------
--------------------------------------------------------------------------------------------------------------------------------------------------------------------------------------------------------
--------------------------------------------------------------------------------------------------------------------------------------------------------------------------------------------------------
--------------------------------------------------------------------------------------------------------------------------------------------------------------------------------------------------------
--------------------------------------------------------------------------------------------------------------------------------------------------------------------------------------------------------
--------------------------------------------------------------------------------------------------------------------------------------------------------------------------------------------------------
--------------------------------------------------------------------------------------------------------------------------------------------------------------------------------------------------------
--------------------------------------------------------------------------------------------------------------------------------------------------------------------------------------------------------
--------------------------------------------------------------------------------------------------------------------------------------------------------------------------------------------------------
--------------------------------------------------------------------------------------------------------------------------------------------------------------------------------------------------------
-------B-------?---o--?----------?-?o-------------?------------?------?--o--?------------?--------?-------B---B---o--o-----Bo-?-?--------?-B-------B--o-------B----------B-------?---B----BoB-----?---v-
-----To-?---------T-------T-----------T----------?--?--o---To----B-Bo---T------?--------T------BT----o---T-------?-------o-----T----o--o--o---T---------T------------T------B----------------T--------f-
-----|-?----------|B-B----|-------B-?-|---o--------------?-|------------|-------T-------|-------|--------|----B-------?------o-|--------?-----|---o---??|-----------o|-?-------?B--o---------|--?-o---f-
--B--|------------|----B-?|--oB-------|-----------B----?---|-----B?-----|-------|-------|-------|--------|----------------oo---|-?o---------?-|---------|----B-------|--------------------?--|B-------f-
-m-E-|-----------E|-------|E----------|----E---------------|------------|-------|-------|--E----|--------|-----E----E----------|------E-----E-|--------E|--E---------|---------E-------------|-E------f-
XXXXXXXXXXXXXXXXXXXXXXXXXXXXXXXXXXXXXXXXXXXXXXXXXXXXXXXXXXXXXXXXXXXXXXXXXXXXXXXXXXXXXXXXXXXXXXXXXXXXXXXXXXXXXXXXXXXXXXXXXXXXXXXXXXXXXXXXXXXXXXXXXXXXXXXXXXXXXXXXXXXXXXXXXXXXXXXXXXXXXXXXXXXXXXXXXXXXXXXX
