--------------------------------------------------------------------------------------------------------------------------------------------------------------------------------------------------------
--------------------------------------------------------------------------------------------------------------------------------------------------------------------------------------------------------
--------------------------------------------------------------------------------------------------------------------------------------------------------------------------------------------------------
--------------------------------------------------------------------------------------------------------------------------------------------------------------------------------------------------------
--------------------------------------------------------------------------------------------------------------------------------------------------------------------------------------------------------
--------------------------------------------------------------------------------------------------------------------------------------------------------------------------------------------------------
--------------------------------------------------------------------------------------------------------------------------------------------------------------------------------------------------------
--------------------------------------------------------------------------------------------------------------------------------------------------------------------------------------------------------
--------------------------------------------------------------------------------------------------------------------------------------------------------------------------------------------------------
--------------------------------------------------------------------------------------------------------------------------------------------------------------------------------------------------------
-------B-------?---?--------?----?-?o-------------?-----------??---o------?-?-----?---------B-------------B---B---o-?o-?---B--?----------?---o-----B-------------B-------B-----?-?---B----BoB-----?---v-
-----T--?----oo---T-------T-------?---T----------?-----o---To----B--o---T---------------T-------T----o---T-------?-------o-----T----o?-o--o---T---------T-----?----?-T-----------------------T-----B--f-
-----|-?-------o--|B-B?---|---------?-|------------------?-|------------|-------T-------|-------|--o-----|----B-----?-?------o-|--------?-----|--Bo---?-|-----------o|-?-------?B--o---------|--?-o---f-
--B--|-----?------|----B--|--oB-------|--------------------|------?---o-|--B----|-------|-------|------?-|----------------oo---|-?--?-------?-|---------|--o---------|--------------------?--|B-------f-
-m---|------------|-------|-----------|----E---------------|------------|-------|-------|----E--|--------|-----E----E----------|------E-----E-|--------E|------------|---------E-------------|-E------f-
XXXXXXXXXXXXXXXXXXXXXXXXXXXXXXXXXXXXXXXXXXXXXXXXXXXXXXXXXXXXXXXXXXXXXXXXXXXXXXXXXXXXXXXXXXXXXXXXXXXXXXXXXXXXXXXXXXXXXXXXXXXXXXXXXXXXXXXXXXXXXXXXXXXXXXXXXXXXXXXXXXXXXXXXXXXXXXXXXXXXXXXXXXXXXXXXXXXXXXXX
