--------------------------------------------------------------------------------------------------------------------------------------------------------------------------------------------------------
--------------------------------------------------------------------------------------------------------------------------------------------------------------------------------------------------------
--------------------------------------------------------------------------------------------------------------------------------------------------------------------------------------------------------
--------------------------------------------------------------------------------------------------------------------------------------------------------------------------------------------------------
--------------------------------------------------------------------------------------------------------------------------------------------------------------------------------------------------------
--------------------------------------------------------------------------------------------------------------------------------------------------------------------------------------------------------
--------------------------------------------------------------------------------------------------------------------------------------------------------------------------------------------------------
--------------------------------------------------------------------------------------------------------------------------------------------------------------------------------------------------------
--------------------------------------------------------------------------------------------------------------------------------------------------------------------------------------------------------
--------------------------------------------------------------------------------------------------------------------------------------------------------------------------------------------------------
----B--B-------?---?--?-?--------?-?o------B--?---B----?--------B---?------B?---------B-----B-------------B---B---o-?o-?---Bo-?-?-B------?---o--B--B--o--?----B-----?-?----------?---BB---BoB-----?---v-
-----T--?----oo---T-------T?--o-------T-?-----------B-?-B-oT-----B------T-o------B-o----T-------T----o---T-------?-------o-----T----oo-o--o---T-----?o--T------------T--o---o----------------T-o------f-
-----|-?-------o--|B-B----|-------B-?-|---------B----------|-------?----|-------T-------|-B-o---|--------|----B-------?------o-|?-------?-----|---o---??|-----------o|-?-------?B--o-------?-|--?-o--of-
--B--|------------|----B-?|--oB?------|?-------------------|?-o-------B-|-------|---?---|-------|?--?--?-|B--------B-?----oo---|-?o-?-------?-|----oo---|----B-------|o--o----------------?--|B-------f-
-m---|----E------E|-------|E----------|----E----E----E-----|------E-----|---E---|-------|----E--|-----E--|-----E----E----------|------------E-|-E------E|--E---------|---------E-------------|-E------f-
XXXXXXXXXXXXXXXXXXXXXXXXXXXXXXXXXXXXXXXXXXXXXXXXXXXXXXXXXXXXXXXXXXXXXXXXXXXXXXXXXXXXXXXXXXXXXXXXXXXXXXXXXXXXXXXXXXXXXXXXXXXXXXXXXXXXXXXXXXXXXXXXXXXXXXXXXXXXXXXXXXXXXXXXXXXXXXXXXXXXXXXXXXXXXXXXXXXXXXXX
