--------------------------------------------------------------------------------------------------------------------------------------------------------------------------------------------------------
--------------------------------------------------------------------------------------------------------------------------------------------------------------------------------------------------------
--------------------------------------------------------------------------------------------------------------------------------------------------------------------------------------------------------
--------------------------------------------------------------------------------------------------------------------------------------------------------------------------------------------------------
--------------------------------------------------------------------------------------------------------------------------------------------------------------------------------------------------------
--------------------------------------------------------------------------------------------------------------------------------------------------------------------------------------------------------
--------------------------------------------------------------------------------------------------------------------------------------------------------------------------------------------------------
--------------------------------------------------------------------------------------------------------------------------------------------------------------------------------------------------------
--------------------------------------------------------------------------------------------------------------------------------------------------------------------------------------------------------
--------------------------------------------------------------------------------------------------------------------------------------------------------------------------------------------------------
----B--B-------?---?--?-?--------?-?o--?---B-----------?-------?B---?------B?---------B-----B------B------B---B---o-?o-?---Bo-?-?-B------?---o--B--B--o--?----B-----?-?----------?---BB---BoB-----?---v-
-----T--?----oo---T-------T?--o-------T-------------B-?-B--To----B------T-o------B-o----T-------T----o---T-------?-------o-----T-o--oo-o--o---T-----?o--T------------T--o--------------------T-o------f-
-----|-?-------o--|B-B----|-------T-?-|--B------B--------?B|-B-----?----|-------T-------|-B-o---|--------|----B-------?------o-|?-------?-----|---o---??|-----------o|-?-------?B--o-------?-|--?-o-?of-
--B--|--------B---|----B-?|--oB?--|---|-----??-------------|----------B-|-------|---?---|-----?-|?--?--?-|---------B------oo---|-?o-?-------?-|-----o---|----B-------|o--o--BB------------?--|B-------f-
-m---|------------|-------|E------|---|----E---------E-----|---E--E-----|---E---|-------|----E--|-----E--|-----E----E----------|------------E-|-E------E|--E---------|---------E-------------|-E------f-
XXXXXXXXXXXXXXXXXXXXXXXXXXXXXXXXXXXXXXXXXXXXXXXXXXXXXXXXXXXXXXXXXXXXXXXXXXXXXXXXXXXXXXXXXXXXXXXXXXXXXXXXXXXXXXXXXXXXXXXXXXXXXXXXXXXXXXXXXXXXXXXXXXXXXXXXXXXXXXXXXXXXXXXXXXXXXXXXXXXXXXXXXXXXXXXXXXXXXXXX
