--------------------------------------------------------------------------------------------------------------------------------------------------------------------------------------------------------
--------------------------------------------------------------------------------------------------------------------------------------------------------------------------------------------------------
--------------------------------------------------------------------------------------------------------------------------------------------------------------------------------------------------------
--------------------------------------------------------------------------------------------------------------------------------------------------------------------------------------------------------
--------------------------------------------------------------------------------------------------------------------------------------------------------------------------------------------------------
--------------------------------------------------------------------------------------------------------------------------------------------------------------------------------------------------------
--------------------------------------------------------------------------------------------------------------------------------------------------------------------------------------------------------
--------------------------------------------------------------------------------------------------------------------------------------------------------------------------------------------------------
--------------------------------------------------------------------------------------------------------------------------------------------------------------------------------------------------------
--------------------------------------------------------------------------------------------------------------------------------------------------------------------------------------------------------
----B--B-------?---?--?-?--------?-?o------B-B?---B----?--------B---?------B?--------BB-----B------?------B---B---o-?o-?---Bo-?---o------?---o-----B--o--?----B-------?----?-o-???---B--B-BoB-----?---v-
-----T--?--o-oo---T-------T?-Bo-------T-?-----------B-?-B-oT-----B------T-o------B-o----T-------T----o---T-------?-B-----o-----T----oo-o--o---T------o--T---?--------T--o--------------------T-----B--f-
-----|-?-------o--|B-B----|-------B-?-|---------B----------|----?--?----|-------T-------|-B-o---|--------|----B-------?------o-|--------?-----|---o---??|----------?o|-?--o----?B--o-----o---|--?-o---f-
--B--|------------|----B-?|-BoB?------|?-------------------|?---------B-|-------|---?---|-------|?--?--?-|---o---------o--oo--o|-?--?-------?-|-----o---|----B-------|o--o---B------------?--|B-------f-
-m---|------------|-------|E----------|----E----E----E-----|------E-----|---E---|-------|----E--|-----E--|-----E----E----------|--E---------E-|-E------E|--E---------|---------E-------------|-E------f-
XXXXXXXXXXXXXXXXXXXXXXXXXXXXXXXXXXXXXXXXXXXXXXXXXXXXXXXXXXXXXXXXXXXXXXXXXXXXXXXXXXXXXXXXXXXXXXXXXXXXXXXXXXXXXXXXXXXXXXXXXXXXXXXXXXXXXXXXXXXXXXXXXXXXXXXXXXXXXXXXXXXXXXXXXXXXXXXXXXXXXXXXXXXXXXXXXXXXXXXX
