--------------------------------------------------------------------------------------------------------------------------------------------------------------------------------------------------------
--------------------------------------------------------------------------------------------------------------------------------------------------------------------------------------------------------
--------------------------------------------------------------------------------------------------------------------------------------------------------------------------------------------------------
--------------------------------------------------------------------------------------------------------------------------------------------------------------------------------------------------------
--------------------------------------------------------------------------------------------------------------------------------------------------------------------------------------------------------
--------------------------------------------------------------------------------------------------------------------------------------------------------------------------------------------------------
--------------------------------------------------------------------------------------------------------------------------------------------------------------------------------------------------------
--------------------------------------------------------------------------------------------------------------------------------------------------------------------------------------------------------
--------------------------------------------------------------------------------------------------------------------------------------------------------------------------------------------------------
--------------------------------------------------------------------------------------------------------------------------------------------------------------------------------------------------------
----B--B-------?---?--?-?--------?-?o------B--?---B----?--------B---?------B?---------B-----B-------------B---B---o-?o-?---Bo-?-?-B------?---o--B--B--oo-?----B-----?-?----?-o-?-?---B----BoB-----?---v-
-----T--?----oo---T-------T?--o-------T-?-----------B-?-B-oT-----B------T-o------B-o----T-------T----o---T-------?-------o-----T----oo?o--o---T-----?o--T------------T--o--------------------T-----B--f-
-----|-?-------o--|B-B----|-------B-?-|---------B----------|-------?----|-------T----?--|-B-o---|--------|----B-------?------o-|?-------?-----|---o---??|----------?o|-?--o----?B--o-----o---|-o?-o---f-
--B--|------------|----B-?|--oB?------|?-------------------|?---------B-|-------|---?---|-------|?--?--?-|---------B------oo---|-?o-?-------?-|-----o---|----B-------|o--o----------------?--|B-------f-
-m---|--E---------|-------|E----------|----E----E----E-----|------E-----|---E---|-------|----E--|-----E--|-----E----E-----E----|------------E-|-E------E|--E---------|---------E-------------|-E------f-
XXXXXXXXXXXXXXXXXXXXXXXXXXXXXXXXXXXXXXXXXXXXXXXXXXXXXXXXXXXXXXXXXXXXXXXXXXXXXXXXXXXXXXXXXXXXXXXXXXXXXXXXXXXXXXXXXXXXXXXXXXXXXXXXXXXXXXXXXXXXXXXXXXXXXXXXXXXXXXXXXXXXXXXXXXXXXXXXXXXXXXXXXXXXXXXXXXXXXXXX
