--------------------------------------------------------------------------------------------------------------------------------------------------------------------------------------------------------
--------------------------------------------------------------------------------------------------------------------------------------------------------------------------------------------------------
--------------------------------------------------------------------------------------------------------------------------------------------------------------------------------------------------------
--------------------------------------------------------------------------------------------------------------------------------------------------------------------------------------------------------
--------------------------------------------------------------------------------------------------------------------------------------------------------------------------------------------------------
--------------------------------------------------------------------------------------------------------------------------------------------------------------------------------------------------------
--------------------------------------------------------------------------------------------------------------------------------------------------------------------------------------------------------
--------------------------------------------------------------------------------------------------------------------------------------------------------------------------------------------------------
--------------------------------------------------------------------------------------------------------------------------------------------------------------------------------------------------------
--------------------------------------------------------------------------------------------------------------------------------------------------------------------------------------------------------
----B--B-------?---?----------?----?o--?---B-----------?-------?B---?------B?---------B-----B-------------B---B---o-?o-?---Bo-?-?-B------?---o--B--B--o--?----B-----?-?----------?---BB---BoB-----?---v-
-----T--?----oo---T-------T-----------T-------------B-?-B--To----B------T-o------B-o----T-------T----o---T-------?-------o-----T----oo-o--o-?-T-----?o--T------------T--o--------------------T-o------f-
---o-|-?-------o--|B-B----|-------T-?-|--B------B--------?B|-B-----??---|-------T-------|-B-o---|--------|----B-------?------o-|?-------?-----|---o---??|-----------o|-?-------?B--o-------?-|--?-o--of-
--B--|------------|-?--B-?|-----o-|---|-----??-------------|----------B-|-------|---?---|-------|?B-?--?-|---------B------oo---|-?o-?-------?-|-----o---|----B-------|o--o----------------?--|B-------f-
-m---|------------|-------|E-----E|---|----E---------E-----|---E--E-----|---E---|-------|----E--|-----E--|-----E----E----------|------------E-|-E------E|--E---------|---------E-------------|-E------f-
XXXXXXXXXXXXXXXXXXXXXXXXXXXXXXXXXXXXXXXXXXXXXXXXXXXXXXXXXXXXXXXXXXXXXXXXXXXXXXXXXXXXXXXXXXXXXXXXXXXXXXXXXXXXXXXXXXXXXXXXXXXXXXXXXXXXXXXXXXXXXXXXXXXXXXXXXXXXXXXXXXXXXXXXXXXXXXXXXXXXXXXXXXXXXXXXXXXXXXXX
