--------------------------------------------------------------------------------------------------------------------------------------------------------------------------------------------------------
--------------------------------------------------------------------------------------------------------------------------------------------------------------------------------------------------------
--------------------------------------------------------------------------------------------------------------------------------------------------------------------------------------------------------
--------------------------------------------------------------------------------------------------------------------------------------------------------------------------------------------------------
--------------------------------------------------------------------------------------------------------------------------------------------------------------------------------------------------------
--------------------------------------------------------------------------------------------------------------------------------------------------------------------------------------------------------
--------------------------------------------------------------------------------------------------------------------------------------------------------------------------------------------------------
--------------------------------------------------------------------------------------------------------------------------------------------------------------------------------------------------------
--------------------------------------------------------------------------------------------------------------------------------------------------------------------------------------------------------
--------------------------------------------------------------------------------------------------------------------------------------------------------------------------------------------------------
----B-BB-------?-?-?---------B---?-?o--?---B-?---------?-----???B---?B-----B?---------B-----B------B----B-B--BB---o-?o-?---Bo-?-?-B------?---o--B--B--oo-?----B?----?-?o---?-o-?-?--oB----BoB-----?---v-
-----T--?--o-oo---T-------T?--o-------T--------B----B-?-B--To----B------T-o------BBo----T-------T----o---T------B?-------o-----T-o--oo-o--o---T-----?o--T------------T--o--------------------T-----B--f-
-----|-?-------oo-|B-B----|-----B-T-?-|--B------B--------?B|-B-----?----|------BT-------|-B-o---|-??----?|---oB-------?------o-|?-----B-?-----|---o---??|----------?o|-?--o----?B--o-----o---|-o?-o--of-
--B--|------o-?---|-?--B-?|--oB?--|---|-----??-------------|----------B-|----B--|-?-?---|-----?-|?--?--?-|-------?-B------oo---|-?o-?-------?-|-----o---|----B-------|o--o----------------?-o|B-----B-f-
-m---|-------E----|---E---|E------|---|----E---------E-----|---E--E-----|---E---|-------|----E--|-----E--|-----E----E----------|------------E-|-E------E|--E---------|---------E-------------|-E------f-
XXXXXXXXXXXXXXXXXXXXXXXXXXXXXXXXXXXXXXXXXXXXXXXXXXXXXXXXXXXXXXXXXXXXXXXXXXXXXXXXXXXXXXXXXXXXXXXXXXXXXXXXXXXXXXXXXXXXXXXXXXXXXXXXXXXXXXXXXXXXXXXXXXXXXXXXXXXXXXXXXXXXXXXXXXXXXXXXXXXXXXXXXXXXXXXXXXXXXXXX
