--------------------------------------------------------------------------------------------------------------------------------------------------------------------------------------------------------
--------------------------------------------------------------------------------------------------------------------------------------------------------------------------------------------------------
--------------------------------------------------------------------------------------------------------------------------------------------------------------------------------------------------------
--------------------------------------------------------------------------------------------------------------------------------------------------------------------------------------------------------
--------------------------------------------------------------------------------------------------------------------------------------------------------------------------------------------------------
--------------------------------------------------------------------------------------------------------------------------------------------------------------------------------------------------------
--------------------------------------------------------------------------------------------------------------------------------------------------------------------------------------------------------
--------------------------------------------------------------------------------------------------------------------------------------------------------------------------------------------------------
--------------------------------------------------------------------------------------------------------------------------------------------------------------------------------------------------------
--------------------------------------------------------------------------------------------------------------------------------------------------------------------------------------------------------
----B-BB-------?---?--?-?--------?-?o------B-----------?-----?-?B---?B-----B?---------B-----B------B------B---B---o-?o-?---Bo-?-?-B?-----?---o--B--B--o--?----B-----?-?--?-?-o-???---B--B-BoB-o-?-?---v-
-----T--?----oo-?-T-------T?-Bo-------T-?------B----B-?-B--To----B------T-o------BBo----T-------T----o---T-------?------?o-----T-B--oo-o--oB?-T-----?o--T------------T--o--------------------T-o------f-
---o-|-?-------o--|BBBo---|-----?-B-?-|---------B--------?B|-B-----?----|-------T-------|-B-o---|--------|---oB-------?------o-|?-------?-----|---o---??|-----------o|-?-------?BB-o-----o---|--?-o--of-
--B--|----------o-|----B-?|-BoB?-o----|?--?-??-------------|----------B-|-------|---?---|-----?-|?--?--?-|---------B------oo---|-?o-?--o----?-|-----o---|----B-------|o--o---B------------?--|B--o--B-f-
-m---|---E-------E|-------|E----------|----E---------E-----|---E--E-----|---E---|-------|----E--|-----E--|-----E----E-------E--|------------E-|-E------E|--E---------|---------E-----E-------|-E------f-
XXXXXXXXXXXXXXXXXXXXXXXXXXXXXXXXXXXXXXXXXXXXXXXXXXXXXXXXXXXXXXXXXXXXXXXXXXXXXXXXXXXXXXXXXXXXXXXXXXXXXXXXXXXXXXXXXXXXXXXXXXXXXXXXXXXXXXXXXXXXXXXXXXXXXXXXXXXXXXXXXXXXXXXXXXXXXXXXXXXXXXXXXXXXXXXXXXXXXXXX
