--------------------------------------------------------------------------------------------------------------------------------------------------------------------------------------------------------
--------------------------------------------------------------------------------------------------------------------------------------------------------------------------------------------------------
--------------------------------------------------------------------------------------------------------------------------------------------------------------------------------------------------------
--------------------------------------------------------------------------------------------------------------------------------------------------------------------------------------------------------
--------------------------------------------------------------------------------------------------------------------------------------------------------------------------------------------------------
--------------------------------------------------------------------------------------------------------------------------------------------------------------------------------------------------------
--------------------------------------------------------------------------------------------------------------------------------------------------------------------------------------------------------
--------------------------------------------------------------------------------------------------------------------------------------------------------------------------------------------------------
--------------------------------------------------------------------------------------------------------------------------------------------------------------------------------------------------------
--------------------------------------------------------------------------------------------------------------------------------------------------------------------------------------------------------
----B--B-------?-?-?-----B-------?-?o--?---B-----------?-----?-?B---?B-----B?o?-------B-----B------B------B---B---o-?o-?---Bo-?-?-B-----??--?B-----B--oB-?----B-----?-?----?-o-???---B--B-BoB-o---?---v-
-----T--?--o-oo---T-------T?--o-------T--------B----B-?-B--To----B------T-o------BBo----T-------T----o---T-------?-------o-----T-o--oo-o------T---------T-------o----T--o--------------------T-----B--f-
-----|-?-------o--|B-B----|-------T-?-|--B-o----B--B-----?B|-B-----?----|-------T-------|-B-o---|--?-----|---oB-------?------o-|?-------?-B---|B--o---??|-----------o|-?-------?BB-o---?-o---|--?-o--?f-
--B--|------B-?-?-|-?--B-?|-ooB?--|---|---B-??-------------|----------B-|----o--|---?---|-----?-|?--?--?-|---------B------oo---|-?o-?-------?-|--o------|----B-------|o--o---B------------?--|B--?----f-
-m---|-------E----|-------|E------|---|----E---------E-----|---E--E-----|---E---|-------|----E--|-----E--|-----E----E----------|------------E-|--------E|--E---------|---------E-------------|-E------f-
XXXXXXXXXXXXXXXXXXXXXXXXXXXXXXXXXXXXXXXXXXXXXXXXXXXXXXXXXXXXXXXXXXXXXXXXXXXXXXXXXXXXXXXXXXXXXXXXXXXXXXXXXXXXXXXXXXXXXXXXXXXXXXXXXXXXXXXXXXXXXXXXXXXXXXXXXXXXXXXXXXXXXXXXXXXXXXXXXXXXXXXXXXXXXXXXXXXXXXXX
