--------------------------------------------------------------------------------------------------------------------------------------------------------------------------------------------------------
--------------------------------------------------------------------------------------------------------------------------------------------------------------------------------------------------------
--------------------------------------------------------------------------------------------------------------------------------------------------------------------------------------------------------
--------------------------------------------------------------------------------------------------------------------------------------------------------------------------------------------------------
--------------------------------------------------------------------------------------------------------------------------------------------------------------------------------------------------------
--------------------------------------------------------------------------------------------------------------------------------------------------------------------------------------------------------
--------------------------------------------------------------------------------------------------------------------------------------------------------------------------------------------------------
--------------------------------------------------------------------------------------------------------------------------------------------------------------------------------------------------------
--------------------------------------------------------------------------------------------------------------------------------------------------------------------------------------------------------
--------------------------------------------------------------------------------------------------------------------------------------------------------------------------------------------------------
----B-BB-------?---?--?-?--------?-?o------B-----------?-------?B---?------B?--?------B-----B------B------B---B---o-?o-?---Bo-?-?-B------?---o--B--B--oo-?----B?----?-?o---?-o-???-?-B--B-BoB-o---?---v-
-----T--?----oo-?-T-------T?-Bo------BT-?------B----B-?-B-oT-----B------T-o--------o----T-------T----o---T-------?-------o-----T-o--oo-o--o---T-----?o--T------------T--o--------------------T-----B--f-
---o-|-?-------o--|BBBo---|-----?-B-?-|---------B--------?-|------o?-B--|-------T------?|-B-o---|--------|-?-oB-------?------o-|?-----B-?-----|---o---??|----------?o|-?--o----?B--o-----o---|--?-o--?f-
--B--|----------o-|----B-?|-BoB?-o----|?--?-??-------------|?--?--------|-------|---?---|--B--?-|?--?--?-|---------B------oo---|-?o-?-------?-|-----o---|----B-------|o--o----------------?--|B--?----f-
-m---|---E-------E|-------|E----------|----E---------E-----|------E-----|---E---|-------|----E--|-----E--|-----E----E----------|------------E-|-E------E|--E---------|---------E-----E-------|-E------f-
XXXXXXXXXXXXXXXXXXXXXXXXXXXXXXXXXXXXXXXXXXXXXXXXXXXXXXXXXXXXXXXXXXXXXXXXXXXXXXXXXXXXXXXXXXXXXXXXXXXXXXXXXXXXXXXXXXXXXXXXXXXXXXXXXXXXXXXXXXXXXXXXXXXXXXXXXXXXXXXXXXXXXXXXXXXXXXXXXXXXXXXXXXXXXXXXXXXXXXXX
