--------------------------------------------------------------------------------------------------------------------------------------------------------------------------------------------------------
--------------------------------------------------------------------------------------------------------------------------------------------------------------------------------------------------------
--------------------------------------------------------------------------------------------------------------------------------------------------------------------------------------------------------
--------------------------------------------------------------------------------------------------------------------------------------------------------------------------------------------------------
--------------------------------------------------------------------------------------------------------------------------------------------------------------------------------------------------------
--------------------------------------------------------------------------------------------------------------------------------------------------------------------------------------------------------
--------------------------------------------------------------------------------------------------------------------------------------------------------------------------------------------------------
--------------------------------------------------------------------------------------------------------------------------------------------------------------------------------------------------------
--------------------------------------------------------------------------------------------------------------------------------------------------------------------------------------------------------
--------------------------------------------------------------------------------------------------------------------------------------------------------------------------------------------------------
----B-BB-------?---?---------B---?-?o--?---B-----------?-----?-?B---?B-----B?---------B-----B------B----B-B--BB---o-?o-?---Bo-?-?-B-----??--?B-----B--o-------B-----?-?----?-o-???---BB-B-BoB-o---?---v-
-----T--?----oo-?-T-------T?--o-------T-?------B----B-?-B--To----B------T-o------BBo----T-------T----o---T-----?B?-------o-----T-o--oo-o------T---------T-------o----T--o--------------------T-----B--f-
---o-|-?-------o--|B-B----|-----o-T-?-|--B------B--------?B|-B-----?----|-------T-------|-B-o---|--?----?|---oB-------?------o-|?-------?-B---|B--o-?-??|-----------o|-?-------?BB-o---?-o---|--?-o--?f-
--B--|----------o-|-?--B-?|--oB?--|---|---B-??-------------|----------B-|----B--|-?-?---|-----?-|?--?--?-|-------?-B------oo---|-?o-?-------?-|--o------|B---B-------|o--o---B-------o----?--|B--?----f-
-m---|---E-------E|-------|E------|---|----E---------E-----|---E--E-----|---E---|-------|----E--|-----E--|-----E----E----------|------------E-|--------E|--E---------|---------E-------------|-E------f-
XXXXXXXXXXXXXXXXXXXXXXXXXXXXXXXXXXXXXXXXXXXXXXXXXXXXXXXXXXXXXXXXXXXXXXXXXXXXXXXXXXXXXXXXXXXXXXXXXXXXXXXXXXXXXXXXXXXXXXXXXXXXXXXXXXXXXXXXXXXXXXXXXXXXXXXXXXXXXXXXXXXXXXXXXXXXXXXXXXXXXXXXXXXXXXXXXXXXXXXX
