--------------------------------------------------------------------------------------------------------------------------------------------------------------------------------------------------------
--------------------------------------------------------------------------------------------------------------------------------------------------------------------------------------------------------
--------------------------------------------------------------------------------------------------------------------------------------------------------------------------------------------------------
--------------------------------------------------------------------------------------------------------------------------------------------------------------------------------------------------------
--------------------------------------------------------------------------------------------------------------------------------------------------------------------------------------------------------
--------------------------------------------------------------------------------------------------------------------------------------------------------------------------------------------------------
--------------------------------------------------------------------------------------------------------------------------------------------------------------------------------------------------------
--------------------------------------------------------------------------------------------------------------------------------------------------------------------------------------------------------
--------------------------------------------------------------------------------------------------------------------------------------------------------------------------------------------------------
--------------------------------------------------------------------------------------------------------------------------------------------------------------------------------------------------------
----B-BB-------?---?--?-?--------?-?o--?---B-----------?-----?-?B---?B?----B?o--------B--B--B------oo---B-B--BB---o-?oo?---Bo-?-?-B-----??--?B--B--B--oo-?----B?----?-?o---?-o-???-?-B--BBBoB-o-?-?---v-
-----T--?o---oo-?-T------?T?-Bo-------T-?------B----B-?-B--To----B------T?o----?-BBo----T-------T----o---T------B?-------o-----T-o--oo-o------T-----?o--T------------T--o-------------B------T-o------f-
---o-|-?-------o--|BBBo---|-----?-B-?-|----B----B--------?B|-B-----?-?--|-------T------B|?B-o---|-------?|B--oB-------?------o-|?-------?-B--B|B-Bo---??|----------?o|-?--o----?B--o---oBo---|--?-o--of-
--B--|-----B-o--o-|----B??|-BoB?-o----|?--?-??-------------|----?-----B-|-?---B-|---?---|------?|?B-?--?-|-------?-B------oo---|-?o-?----?-B?-|-----o---|----B-------|o--o------------?---?--|B--o--B-f-
-m---|---E-------E|-------|E----------|----E---------E-----|---E--E-----|---E---|-------|----E--|-----E--|-----E----E----------|------------E-|-E------E|--E------E--|---------E-----E-------|-E------f-
XXXXXXXXXXXXXXXXXXXXXXXXXXXXXXXXXXXXXXXXXXXXXXXXXXXXXXXXXXXXXXXXXXXXXXXXXXXXXXXXXXXXXXXXXXXXXXXXXXXXXXXXXXXXXXXXXXXXXXXXXXXXXXXXXXXXXXXXXXXXXXXXXXXXXXXXXXXXXXXXXXXXXXXXXXXXXXXXXXXXXXXXXXXXXXXXXXXXXXXX
